YWHAB	Apoptosis
YWHAB	Developmental Biology
YWHAE	Apoptosis
HLA-B	Immune System
HLA-C	Immune System
PPP2R5A	Cell Cycle
PPP2R2A	Cell Cycle
PPP2R5E	Cell Cycle
PPP2R1B	Cell Cycle
PPP2R1A	Cell Cycle
HSD3B2	Metabolism
HSD3B1	Metabolism
PPP2R3B	Cell Cycle
YWHAH	Apoptosis
YWHAG	Apoptosis
YWHAZ	Apoptosis
SFN	Apoptosis
YWHAQ	Apoptosis
HLA-A	Immune System
COPB1	Membrane Trafficking
COPA	Membrane Trafficking
COPE	Membrane Trafficking
ARCN1	Membrane Trafficking
COPB2	Membrane Trafficking
COPG1	Membrane Trafficking
COPZ1	Membrane Trafficking
COQ3	Metabolism
COQ7	Metabolism
COQ6	Metabolism
NR2F1	Gene Expression
MT-CO1	Metabolism
MT-CO2	Metabolism
MT-CO3	Metabolism
COX5A	Metabolism
COX5B	Metabolism
COX6A1	Metabolism
COX6B1	Metabolism
COX6C	Metabolism
C8B	Immune System
C8A	Immune System
C7	Immune System
ACACB	Disease
C9	Immune System
C8G	Immune System
EBF1	Developmental Biology
CFL1	Developmental Biology
CLPS	Disease
COMP	Extracellular matrix organization
POMC	Metabolism of proteins
SLC31A1	Transmembrane transport of small molecules
COMT	Metabolism
CNTN1	Developmental Biology
CYP2E1	Metabolism
CYP2D6	Metabolism
CYP4F3	Metabolism
CYP4F2	Metabolism
CYP2C9	Metabolism
CYP2C19	Metabolism
CYP2C18	Metabolism
CYP11B1	Metabolism
CYP2J2	Metabolism
CYP21A2	Metabolism
CYP11B2	Metabolism
CYP4F11	Metabolism
CYP4F8	Metabolism
CYP4F12	Metabolism
CPT1A	Circadian Clock
CPT2	Metabolism
CYP17A1	Metabolism
CPT1B	Metabolism
CPS1	Metabolism
CYP19A1	Metabolism
COX10	Metabolism
COX17	Metabolism of proteins
COX8A	Metabolism
COX7C	Metabolism
COX7B	Metabolism
CYP27B1	Metabolism
CYP27A1	Metabolism
CYP26A1	Metabolism
CYP24A1	Metabolism
CYP1B1	Metabolism
CYP1A2	Metabolism
CYP1A1	Metabolism
CYP51A1	Metabolism
CYP7A1	Metabolism
CYP4B1	Metabolism
CYP4A11	Metabolism
CYP3A7	Metabolism
CYP46A1	Metabolism
CYP3A4	Metabolism
CYP3A5	Metabolism
CYP2B6	Metabolism
CYP2C8	Metabolism
CYP2A13	Metabolism
CYP2A6	Metabolism
CYP2A7	Metabolism
CYP7B1	Metabolism
CYP8B1	Metabolism
CLOCK	Chromatin organization
SLC25A12	Disease
CYSLTR1	Signal Transduction
CLU	Hemostasis
CYSLTR2	Signal Transduction
CLDN7	Cell-Cell communication
CLDN8	Cell-Cell communication
CLDN5	Cell-Cell communication
CLDN6	Cell-Cell communication
CLDN11	Cell-Cell communication
CLDN12	Cell-Cell communication
CLDN9	Cell-Cell communication
CLDN10	Cell-Cell communication
CLCN7	Transmembrane transport of small molecules
CLTA	Developmental Biology
CLDN3	Cell-Cell communication
CLDN4	Cell-Cell communication
CLDN1	Cell-Cell communication
CLDN2	Cell-Cell communication
CLTC	Immune System
CLDN17	Cell-Cell communication
CLDN16	Cell-Cell communication
CLDN15	Cell-Cell communication
CLDN14	Cell-Cell communication
CLDN20	Cell-Cell communication
CLDN19	Cell-Cell communication
CLDN18	Cell-Cell communication
CNOT7	Gene Expression
PDE6A	Disease
PDE6B	Disease
CNGB1	Disease
CNGA1	Disease
C5	Immune System
COX7A2L	Metabolism
C6	Immune System
C3	Immune System
C2	Immune System
PDE6G	Disease
CNOT8	Gene Expression
PDE3A	Hemostasis
PDE3B	Hemostasis
PDE2A	Hemostasis
PDE1B	Disease
PDE1C	Disease
PDE10A	Hemostasis
PDE1A	Disease
GPER	Signal Transduction
SLC35A1	Metabolism of proteins
SLC25A13	Disease
PDE9A	Hemostasis
PDE8B	Signal Transduction
PDE8A	Signal Transduction
PDE7B	Signal Transduction
PDE7A	Signal Transduction
PDE5A	Hemostasis
PDE4D	Signal Transduction
PDE4C	Signal Transduction
PDE4B	Signal Transduction
PDE4A	Signal Transduction
MIS18A	Cell Cycle
SLC7A1	Amino acid and oligopeptide SLC transporters
PCYT1B	Metabolism
PCYT1A	Metabolism
CTRB1	Disease
CTGF	Gene Expression
DSN1	Cell Cycle
CHMP4B	Disease
CTLA4	Immune System
CTNNA1	Cell-Cell communication
CTNNA2	Developmental Biology
CTNNB1	Apoptosis
CKAP5	Cell Cycle
CTNND1	Cell-Cell communication
CYC1	Metabolism
GJB6	Membrane Trafficking
XCR1	Signal Transduction
GJB4	Membrane Trafficking
GJB5	Membrane Trafficking
ADCY7	Disease
ADCY8	Disease
ADCY5	Disease
ADCY6	Disease
ADCY3	Disease
ADCY4	Disease
ADCY1	Disease
ADCY2	Disease
GJA5	Membrane Trafficking
GJA4	Membrane Trafficking
GJA3	Membrane Trafficking
GJA1	Membrane Trafficking
COX4I1	Metabolism
GJB3	Membrane Trafficking
GJB2	Membrane Trafficking
GJB1	Membrane Trafficking
CXADR	Hemostasis
GJD2	Membrane Trafficking
GJA8	Membrane Trafficking
GJC1	Membrane Trafficking
CUL2	Cellular responses to stress
CUL3	Immune System
CTSL2	Extracellular matrix organization
CSK	Disease
CASK	Cell-Cell communication
CSAD	Metabolism
ERCC8	DNA Repair
CSF2	Immune System
CALR	Binding and Uptake of Ligands by Scavenger Receptors
CRKL	Immune System
CRK	Hemostasis
CRHR2	Signal Transduction
CRH	Signal Transduction
TDGF1	Developmental Biology
CREB1	Developmental Biology
CRHR1	Signal Transduction
RLBP1	Disease
MASP1	Binding and Uptake of Ligands by Scavenger Receptors
CR1	Immune System
CNTNAP1	Developmental Biology
SLC52A3	Disease
EDEM2	Metabolism of proteins
SPTLC3	Metabolism
GAL3ST1	Metabolism
MED7	Developmental Biology
MED17	Developmental Biology
NCBP1	Disease
CNR2	Signal Transduction
NCBP2	Disease
CNR1	Signal Transduction
CAPZA2	Hemostasis
CAPZA1	Hemostasis
CABLES2	Hemostasis
NFYB	Metabolism
CPA3	Metabolism of proteins
CPD	Membrane Trafficking
CPB1	Metabolism of proteins
SERPINH1	Extracellular matrix organization
CBL	Disease
CBX2	Cellular responses to stress
CBS	Metabolism
CPN1	Metabolism of proteins
CREBBP	Cellular responses to stress
CPE	Metabolism of proteins
CBX8	Cellular responses to stress
CBX4	Cellular responses to stress
CBX6	Cellular responses to stress
CBX5	Hemostasis
CACNA1E	Metabolism
CACNA1B	Neuronal System
CACNA1A	Metabolism
CACNB1	Developmental Biology
CACNB2	Developmental Biology
CACNB3	Developmental Biology
CACNB4	Developmental Biology
CACNA1G	Developmental Biology
CACNA1I	Developmental Biology
CACNA1S	Developmental Biology
CCK	Signal Transduction
CCKAR	Signal Transduction
CCNT2	Disease
CXCR6	Signal Transduction
CD19	Disease
CD14	Immune System
CD24	Developmental Biology
CD28	Disease
CD36	Binding and Uptake of Ligands by Scavenger Receptors
CD2	Hemostasis
CD3E	Immune System
CD3D	Immune System
CD3G	Immune System
PTPRC	Developmental Biology
CD44	Disease
CD48	Hemostasis
CD47	Cell-Cell communication
CD4	Disease
CD59	Immune System
CDK5R1	Developmental Biology
CD63	Hemostasis
CD72	Developmental Biology
CD80	Disease
CD86	Disease
CD8A	Immune System
CDH10	Cell-Cell communication
CDH11	Cell-Cell communication
CDH8	Cell-Cell communication
CDH9	Cell-Cell communication
CDH6	Cell-Cell communication
CDH7	Cell-Cell communication
CDH4	Cell-Cell communication
CDH5	Cell-Cell communication
CDH2	Cell-Cell communication
CDH3	Cell-Cell communication
CRAT	Metabolism
CDH1	Apoptosis
CABIN1	Cellular responses to stress
CA3	Metabolism
CA2	Metabolism
CA1	Metabolism
CDH18	Cell-Cell communication
CDH15	Cell-Cell communication
CDH13	Cell-Cell communication
CDH12	Cell-Cell communication
CALCB	Signal Transduction
PPP3R1	Apoptosis
CA12	Metabolism
CA14	Metabolism
KCNMB1	Hemostasis
CA9	Cellular responses to stress
CA4	Metabolism
CA5A	Metabolism
CA6	Metabolism
CA7	Metabolism
CALM1	Calcineurin dephosphorylates NFATC1,2,3
CAPN1	Extracellular matrix organization
L1CAM	Developmental Biology
CANX	Immune System
MATN1	Extracellular matrix organization
CALCR	Signal Transduction
CALU	Hemostasis
CAPZB	Hemostasis
CARD9	Immune System
NOD1	Immune System
ACOX2	Metabolism
CAPNS1	Extracellular matrix organization
CAP2	Developmental Biology
CAP1	Developmental Biology
ACOX3	Metabolism
CSN2	Signal Transduction
CRTAP	Extracellular matrix organization
CASR	Signal Transduction
CAT	Cellular responses to stress
CTSB	Extracellular matrix organization
CTSC	Immune System
CARD11	Immune System
NLRC4	Immune System
NOD2	Immune System
CTSS	Extracellular matrix organization
CTSZ	Membrane Trafficking
CAV1	Hemostasis
CTSD	Extracellular matrix organization
CTSG	Extracellular matrix organization
CTSF	Immune System
CTSK	Extracellular matrix organization
CTSH	Immune System
CTSO	Immune System
CTH	Metabolism
CALCRL	Signal Transduction
HSPD1	Metabolism of proteins
CXXC1	Metabolism of proteins
FAM96B	Metabolism
CNDP2	Metabolism
CGB	Metabolism of proteins
CLCNKB	Transmembrane transport of small molecules
CLCNKA	Transmembrane transport of small molecules
SCN2B	Developmental Biology
SCN3B	Developmental Biology
CIAO1	Metabolism
SCN1B	Developmental Biology
KCNA6	Neuronal System
KCNC4	Neuronal System
KCNA4	Neuronal System
KCNA5	Neuronal System
KCNA2	Neuronal System
KCNA3	Neuronal System
KCNA1	Neuronal System
BCHE	Metabolism
CISH	Immune System
CS	Metabolism
KCNK1	Neuronal System
KCNK2	Neuronal System
KCNK3	Neuronal System
KCNK4	Neuronal System
KCNK6	Neuronal System
KCNK7	Neuronal System
KCNK9	Neuronal System
KCNK10	Neuronal System
KCNK13	Neuronal System
SCN1A	Developmental Biology
SCN3A	Developmental Biology
SCN2A	Developmental Biology
SCN5A	Developmental Biology
SCN4A	Developmental Biology
CGN	Disease
SCN7A	Developmental Biology
KCNQ1	Neuronal System
TRIP10	Signal Transduction
KCNQ3	Developmental Biology
KCNQ2	Developmental Biology
KCNQ5	Neuronal System
KCNQ4	Neuronal System
NLRP3	Immune System
CCR10	Signal Transduction
CCR7	Signal Transduction
CCR8	Signal Transduction
CCRL1	Signal Transduction
CLCN1	Transmembrane transport of small molecules
CLCN2	Transmembrane transport of small molecules
CLCN5	Transmembrane transport of small molecules
CLCN6	Transmembrane transport of small molecules
CLCN3	Transmembrane transport of small molecules
CLCN4	Transmembrane transport of small molecules
KCNK17	Neuronal System
CCR1	Signal Transduction
CCBP2	Signal Transduction
CCR6	Immune System
CCR5	Disease
CCR4	Signal Transduction
CCR3	Signal Transduction
CD97	Signal Transduction
CD9	Hemostasis
CDS2	Metabolism
CDS1	Metabolism
CDA	Metabolism
CDC7	Cell Cycle
CENPC1	Cell Cycle
CP	Transmembrane transport of small molecules
AGAP2	Developmental Biology
UGCG	Metabolism
CENPA	Cell Cycle
CEBPA	Developmental Biology
CEBPB	Cellular responses to stress
CEBPD	Developmental Biology
SF3B14	Gene Expression
MAMLD1	Disease
CCNC	Developmental Biology
SAMM50	Metabolism of proteins
CFI	Immune System
CFLAR	Apoptosis
CFD	Hemostasis
CFH	Immune System
CFTR	Transmembrane transport of small molecules
CETP	Metabolism
CFB	Immune System
BCAP31	Apoptosis
B4GALT6	Disease
B4GALT5	Disease
B4GALT7	Disease
B4GALT2	Disease
B4GALT1	Disease
B4GALT4	Disease
B4GALT3	Disease
BANF1	Cell Cycle
BAD	Apoptosis
B2M	Disease
ADRB2	Signal Transduction
ADRB1	Signal Transduction
CNTN2	Developmental Biology
AXIN1	Signal Transduction
ACVR2B	Developmental Biology
ACVR2A	Developmental Biology
B3GNT3	Disease
MPC1	Metabolism
B3GNT1	Disease
B3GNT2	Disease
B3GAT2	Disease
B3GAT3	Disease
SLC4A1	Metabolism
B3GAT1	Disease
SLC4A3	Transmembrane transport of small molecules
ADRB3	Signal Transduction
SLC4A2	Transmembrane transport of small molecules
ATP5I	Metabolism
ATP5C1	Metabolism
ATP5L	Metabolism
ATP5J2	Metabolism
ATP5H	Metabolism
ATP5O	Metabolism
ATP5J	Metabolism
MT-ATP6	Metabolism
ATP5A1	Metabolism
MT-ATP8	Metabolism
ATP5D	Metabolism
ATP5B	Metabolism
ATP5F1	Metabolism
ATP5E	Metabolism
ADAMTS8	Extracellular matrix organization
TAT	Metabolism
ADAMTS1	Extracellular matrix organization
ADAMTS2	Extracellular matrix organization
ADAMTS3	Extracellular matrix organization
ADAMTS4	Extracellular matrix organization
ADAMTS5	Extracellular matrix organization
ATP2B3	Hemostasis
ATP2B2	Hemostasis
ATP2B1	Hemostasis
SAT1	Metabolism
ATP2C2	Transmembrane transport of small molecules
ATP2C1	Transmembrane transport of small molecules
ATP9A	Transmembrane transport of small molecules
ATP5G1	Metabolism
ATP2A3	Hemostasis
ATP2A2	Hemostasis
ATP2A1	Hemostasis
ATP9B	Transmembrane transport of small molecules
ATP1B1	Hemostasis
ATP4B	Transmembrane transport of small molecules
ATP12A	Transmembrane transport of small molecules
FXYD2	Transmembrane transport of small molecules
ATP1B2	Hemostasis
ATP1B3	Hemostasis
ATF4	Metabolism of proteins
ATF1	Immune System
ATF2	Chromatin organization
ATP4A	Transmembrane transport of small molecules
ASB4	Immune System
ASB5	Immune System
ASB6	Immune System
ASB7	Immune System
ASB1	Immune System
ASB2	Immune System
ASB3	Immune System
SMPD1	Metabolism
ASNS	Metabolism
ASB8	Immune System
ASB9	Immune System
PYCARD	Immune System
ASS1	Metabolism
ADAMTS14	Extracellular matrix organization
ASPN	Extracellular matrix organization
ATF6	Metabolism of proteins
ATP7B	Transmembrane transport of small molecules
ATP7A	Cellular responses to stress
ADAMTS18	Extracellular matrix organization
ARRB2	Disease
ARSE	Metabolism
ARSF	Metabolism
ARSB	Disease
ARSD	Metabolism
ARSA	Metabolism
SAG	Disease
ASB12	Immune System
ASB11	Immune System
ASB10	Immune System
NAT2	Metabolism
NAT1	Metabolism
ERAP1	Immune System
ASAH1	Metabolism
ASB17	Immune System
ASB16	Immune System
ASB15	Immune System
ASB13	Immune System
ARFGAP1	Membrane Trafficking
ARG2	Metabolism
ARG1	Metabolism
ARHGEF6	Cell-Cell communication
ARIH1	Immune System
ARIH2	Immune System
ADRBK1	Disease
ASL	Metabolism
ACTR2	Immune System
ARNT	Cellular responses to stress
ACTR3	Immune System
AQP3	Transmembrane transport of small molecules
AQP4	Transmembrane transport of small molecules
AQP1	Metabolism
AQP2	Transmembrane transport of small molecules
AQP7	Transmembrane transport of small molecules
AQP8	Cellular responses to stress
AQP5	Transmembrane transport of small molecules
AQP6	Transmembrane transport of small molecules
ARPC5	Immune System
ARPC1A	Immune System
AQP9	Transmembrane transport of small molecules
AQP10	Transmembrane transport of small molecules
ARPC3	Immune System
ARPC2	Immune System
ARF1	Disease
ARF3	Metabolism
COL4A6	Extracellular matrix organization
COL4A5	Developmental Biology
CA5B	Metabolism
COL9A3	Developmental Biology
COL4A4	Developmental Biology
COL5A3	Developmental Biology
COL6A3	Developmental Biology
COL11A2	Extracellular matrix organization
COL4A3	Developmental Biology
COL8A2	Extracellular matrix organization
COL9A2	Developmental Biology
COL6A2	Developmental Biology
COL5A2	Developmental Biology
COL4A2	Binding and Uptake of Ligands by Scavenger Receptors
COL1A2	Binding and Uptake of Ligands by Scavenger Receptors
COL19A1	Extracellular matrix organization
COL18A1	Extracellular matrix organization
COL16A1	Extracellular matrix organization
COL15A1	Extracellular matrix organization
COL12A1	Extracellular matrix organization
COL11A1	Extracellular matrix organization
COL10A1	Extracellular matrix organization
COL9A1	Developmental Biology
COL8A1	Extracellular matrix organization
COL7A1	Extracellular matrix organization
COL6A1	Developmental Biology
COL2A1	Developmental Biology
COL3A1	Binding and Uptake of Ligands by Scavenger Receptors
COL4A1	Binding and Uptake of Ligands by Scavenger Receptors
COL5A1	Developmental Biology
CD79B	Immune System
COL1A1	Binding and Uptake of Ligands by Scavenger Receptors
C5AR1	Signal Transduction
C5AR2	Signal Transduction
CD79A	Immune System
C4BPB	Immune System
C4BPA	Immune System
SDHC	Metabolism
CYP39A1	Metabolism
C3AR1	Signal Transduction
CYP26B1	Metabolism
CYBB	Disease
CIITA	Immune System
CYP2F1	Metabolism
C1S	Immune System
C1R	Immune System
CYBA	Disease
MTHFD1	Disease
C1QC	Immune System
C1QA	Immune System
C1QB	Immune System
EDEM3	Metabolism of proteins
CYP11A1	Metabolism
CD151	Cell-Cell communication
ALCAM	Developmental Biology
CHMP4A	Disease
UPB1	Metabolism
BUB3	APC-Cdc20 mediated degradation of Nek2A
CD160	Immune System
BTK	Immune System
BTC	Disease
BTD	Disease
BRPF3	Chromatin organization
BRS3	Signal Transduction
BDKRB1	Signal Transduction
BRCA1	Cell Cycle
BDKRB2	Signal Transduction
BRCA2	Cell Cycle
BBOX1	Metabolism
ASIC1	Transmembrane transport of small molecules
ASIC2	Transmembrane transport of small molecules
POLR3D	Gene Expression
BMX	Apoptosis
MPC2	Metabolism
HLCS	Disease
BMP4	Extracellular matrix organization
BMP2	Extracellular matrix organization
BMI1	Cellular responses to stress
BMPR1B	Signal Transduction
BMPR2	Signal Transduction
BMPR1A	Signal Transduction
BMP7	Extracellular matrix organization
BLMH	Immune System
BLK	Immune System
XIAP	Apoptosis
BIRC2	Apoptosis
BIRC5	Cell Cycle
BMP10	Extracellular matrix organization
BLM	Cell Cycle
BID	Apoptosis
BLVRA	Metabolism
BHLHE40	Circadian Clock
BHLHE41	Circadian Clock
BHMT	Metabolism
BIRC3	Immune System
ARFGEF2	Metabolism of proteins
BDH1	Metabolism
GLB1	Disease
GUSB	Disease
TGFBI	Disease
BCL2	Apoptosis
BCAT1	Metabolism
BCL10	Immune System
BCL2L1	Apoptosis
DEFB4A	Immune System
BCR	Disease
BCAR1	Hemostasis
BCAT2	Metabolism
BAK1	Apoptosis
CEL	Metabolism
BSG	Extracellular matrix organization
SLC7A9	Amino acid and oligopeptide SLC transporters
EHMT2	Cellular responses to stress
BAX	Apoptosis
NDUFAB1	Metabolism
ACO2	Metabolism
ACTA2	Muscle contraction
ACSS2	Metabolism
ACR	Reproduction
CHRM2	Signal Transduction
CHRM1	Signal Transduction
ACLY	Metabolism
ACIN1	Apoptosis
CHRM5	Signal Transduction
CHRM4	Signal Transduction
CHRM3	Metabolism
ACTB	Cell-Cell communication
ACTG2	Muscle contraction
MC2R	Signal Transduction
ACTG1	Cell-Cell communication
ADAM2	Reproduction
ADAM8	Extracellular matrix organization
ACTR1B	Immune System
ACTR1A	Cell Cycle
ABCD2	Transmembrane transport of small molecules
ABCA4	Disease
ABCB8	Transmembrane transport of small molecules
ABCB6	Transmembrane transport of small molecules
ABCA3	Transmembrane transport of small molecules
ABCA2	Transmembrane transport of small molecules
ABCA1	Metabolism
RFC5	Cell Cycle
DDX41	Immune System
ABL2	Developmental Biology
ABCG8	Metabolism
ABCG4	Transmembrane transport of small molecules
ABCG5	Metabolism
ABCG2	Metabolism
ACHE	Metabolism
ACADVL	Metabolism
ACE	Metabolism of proteins
ACADL	Metabolism
ACADSB	Metabolism
ACADS	Metabolism
ACADM	Metabolism
ACAD8	Metabolism
ABCC9	Neuronal System
CHRNB2	Neuronal System
CHRNB3	Neuronal System
CHRNB4	Neuronal System
CHRND	Neuronal System
CHRNE	Neuronal System
CHRNG	Neuronal System
CHRNA6	Neuronal System
CHRNA7	Neuronal System
CHRNA9	Neuronal System
CHRNA1	Neuronal System
CHRNA2	Neuronal System
CHRNA3	Neuronal System
CHRNA4	Neuronal System
CHRNA5	Neuronal System
AP2M1	Developmental Biology
A2M	Extracellular matrix organization
AP2S1	Developmental Biology
ANP32A	Gene Expression
AP3M1	Metabolism of proteins
AP3B1	Membrane Trafficking
AP4E1	Membrane Trafficking
AP4B1	Membrane Trafficking
ATP8A1	Transmembrane transport of small molecules
ATP8A2	Transmembrane transport of small molecules
ATP8B1	Transmembrane transport of small molecules
ATP8B2	Transmembrane transport of small molecules
ATP8B3	Transmembrane transport of small molecules
ADORA1	Signal Transduction
ADORA2A	Signal Transduction
ADORA2B	Signal Transduction
ADORA3	Signal Transduction
SLC7A10	Amino acid and oligopeptide SLC transporters
AAAS	Cell Cycle
SLC1A5	Amino acid and oligopeptide SLC transporters
ACTN1	Cell-Cell communication
ACTN2	Cell-Cell communication
ACTN3	Cell-Cell communication
ACTN4	Cell-Cell communication
PRKAA2	Membrane Trafficking
PRKAA1	Signal Transduction
PRKAB2	Membrane Trafficking
PRKAB1	Membrane Trafficking
PRKAG2	Membrane Trafficking
PRKAG1	Membrane Trafficking
PRKAG3	Membrane Trafficking
GOT2	Disease
GOT1	Disease
ABCB11	Metabolism
ABCB10	Transmembrane transport of small molecules
HTR1A	Signal Transduction
HTR1B	Signal Transduction
SLC3A2	Amino acid and oligopeptide SLC transporters
MPG	DNA Repair
HAAO	Metabolism
HTR4	Signal Transduction
HTR5A	Signal Transduction
HTR2B	Signal Transduction
HTR1F	Signal Transduction
HTR2A	Signal Transduction
HTR1D	Signal Transduction
HTR1E	Signal Transduction
PGD	Disease
NT5E	Metabolism
NT5C2	Metabolism
HTR3A	Transmembrane transport of small molecules
HTR7	Signal Transduction
HTR6	Signal Transduction
ATP11A	Transmembrane transport of small molecules
ATP10D	Transmembrane transport of small molecules
ATP10A	Transmembrane transport of small molecules
ATP10B	Transmembrane transport of small molecules
PGLS	Disease
ATP1A3	Transmembrane transport of small molecules
ATP1A4	Transmembrane transport of small molecules
ADRA1A	Signal Transduction
ADRA1B	Signal Transduction
ATP11B	Transmembrane transport of small molecules
ATP1A1	Transmembrane transport of small molecules
ATP1A2	Transmembrane transport of small molecules
AP1B1	Disease
AP1G1	Disease
ADRA1D	Signal Transduction
SERPINA1	Hemostasis
AP1S2	Disease
AP2A1	Developmental Biology
AP1S3	Disease
AP1M1	Disease
AP1S1	Disease
AP1M2	Disease
AP2B1	Developmental Biology
SERPINF2	Hemostasis
ADRA2A	Hemostasis
AP2A2	Developmental Biology
ADRA2B	Hemostasis
APOA2	Disease
APOA4	Disease
APAF1	Apoptosis
APOB	Binding and Uptake of Ligands by Scavenger Receptors
JUN	Cellular responses to stress
APOA1	Binding and Uptake of Ligands by Scavenger Receptors
MAOB	Metabolism
MAOA	Metabolism
ARPP19	Cell Cycle
APRT	Metabolism
PMAIP1	Apoptosis
ADIPOQ	Developmental Biology
LPA	Metabolism
ACER3	Metabolism
ATG12	Immune System
ATG5	Immune System
APOL1	Binding and Uptake of Ligands by Scavenger Receptors
APLNR	Signal Transduction
APOC3	Disease
APOC2	Disease
APOE	Binding and Uptake of Ligands by Scavenger Receptors
APLN	Signal Transduction
APEX1	DNA Repair
AR	Gene Expression
NAGLU	Disease
AMY2B	Disease
AMY2A	Disease
AMY1A	Disease
ANPEP	Metabolism of proteins
METAP2	Disease
ENPEP	Metabolism of proteins
METAP1	Disease
AMPD3	Metabolism
AMPD2	Metabolism
AMACR	Metabolism
AMPD1	Metabolism
AMBP	Binding and Uptake of Ligands by Scavenger Receptors
SERPINC1	Hemostasis
ANXA1	Signal Transduction
ANGPTL4	Developmental Biology
ANK3	Developmental Biology
ANK2	Developmental Biology
ANK1	Developmental Biology
AGT	Metabolism
NPPA	Disease
AKR1B10	Disease
AKAP9	Cell Cycle
AKR1C2	Metabolism
AKR1C1	Disease
AKR1C4	Disease
AKR1C3	Disease
AGXT2	Metabolism
AIM2	Immune System
AKAP10	Hemostasis
ALG8	Metabolism of proteins
GFER	Metabolism of proteins
AKT2	Apoptosis
AKR1D1	Metabolism
AKAP1	Hemostasis
IGHA1	Binding and Uptake of Ligands by Scavenger Receptors
IGHA2	Binding and Uptake of Ligands by Scavenger Receptors
GPT	Metabolism
ALB	Binding and Uptake of Ligands by Scavenger Receptors
ALDOA	Disease
ALDOB	Disease
AKR1B1	Metabolism
ABCD1	Metabolism
ALG5	Metabolism of proteins
ALG6	Metabolism of proteins
ALDOC	Disease
ALG3	Metabolism of proteins
ADD1	Apoptosis
PLIN2	Metabolism
ADA	Metabolism
AGPS	Metabolism
ADH4	Metabolism
ADH1C	Metabolism
ADK	Metabolism
ADH7	Metabolism
ADH6	Metabolism
ADH1B	Metabolism
ADH1A	Metabolism
ADAM15	Extracellular matrix organization
ADAM17	Apoptosis
ADAM9	Extracellular matrix organization
ADAM10	Disease
ADAM12	Disease
ADAM30	Reproduction
ADAM20	Reproduction
ADAM21	Reproduction
AGTR2	Signal Transduction
ANGPT4	Hemostasis
ANGPT2	Hemostasis
ANGPT1	Hemostasis
PGM3	Metabolism of proteins
GLA	Metabolism
AGTR1	Signal Transduction
SLC25A4	Disease
FDXR	Metabolism
AOX1	Disease
ADM	Signal Transduction
FDX1	Metabolism
SLC25A5	Disease
SLC25A6	Disease
ALAS2	Metabolism
ALAD	Metabolism
ALAS1	Metabolism
UROS	Metabolism
CPOX	Metabolism
HDAC6	Cellular responses to stress
HDGF	Metabolism of proteins
HCN3	Neuronal System
HCN4	Neuronal System
HDAC11	Disease
HDAC1	Cell Cycle
HDAC2	Disease
HDAC4	Disease
HSD17B10	Metabolism
HADH	Metabolism
HCK	Disease
HCN1	Neuronal System
HCN2	Neuronal System
HBEGF	Disease
HBE1	Hemostasis
HBD	Hemostasis
HLA-DPB1	Immune System
HLA-DRB4	Immune System
HLA-DOB	Immune System
HLA-DQB2	Immune System
HLA-DRB1	Immune System
HMGCS2	Metabolism
HCAR3	Signal Transduction
HLA-F	Immune System
HLA-E	Immune System
HLA-G	Immune System
HKR1	Gene Expression
HIRA	Cellular responses to stress
HIP1R	Membrane Trafficking
HIF1A	Cellular responses to stress
HRH4	Signal Transduction
HRH3	Signal Transduction
HRH2	Signal Transduction
HRH1	Signal Transduction
HGF	Hemostasis
HGD	Metabolism
CD74	Immune System
HEY1	Disease
HEXA	Disease
HEXB	Disease
HES1	Developmental Biology
HPX	Binding and Uptake of Ligands by Scavenger Receptors
FECH	Metabolism
PLA2G16	Metabolism
HSPB1	Gene Expression
HSPA1A	Cellular responses to stress
HSPA2	Cell Cycle
HSPA8	Cellular responses to stress
HSP90AA1	Binding and Uptake of Ligands by Scavenger Receptors
HSP90AB1	Cellular responses to stress
HPRT1	Metabolism
HP	Binding and Uptake of Ligands by Scavenger Receptors
HPR	Binding and Uptake of Ligands by Scavenger Receptors
HRG	Hemostasis
FOXA3	Developmental Biology
HNF4G	Developmental Biology
ONECUT1	Developmental Biology
HMOX2	Metabolism
HMOX1	Metabolism
HACL1	Metabolism
HPD	Metabolism
HMGCS1	Metabolism
HMGB2	Apoptosis
HMGB1	Apoptosis
HMMR	Disease
EHMT1	Cellular responses to stress
Ig heavy chain V-III region JON	Binding and Uptake of Ligands by Scavenger Receptors
Ig heavy chain V-III region GAL	Binding and Uptake of Ligands by Scavenger Receptors
Ig heavy chain V-III region DOB	Binding and Uptake of Ligands by Scavenger Receptors
Ig heavy chain V-III region WAS	Binding and Uptake of Ligands by Scavenger Receptors
Ig heavy chain V-III region TEI	Binding and Uptake of Ligands by Scavenger Receptors
Ig heavy chain V-III region ZAP	Binding and Uptake of Ligands by Scavenger Receptors
Ig heavy chain V-III region TUR	Binding and Uptake of Ligands by Scavenger Receptors
Ig heavy chain V-III region TIL	Binding and Uptake of Ligands by Scavenger Receptors
Ig heavy chain V-III region VH26	Binding and Uptake of Ligands by Scavenger Receptors
Ig heavy chain V-III region BUT	Binding and Uptake of Ligands by Scavenger Receptors
Ig heavy chain V-III region BRO	Binding and Uptake of Ligands by Scavenger Receptors
Ig heavy chain V-II region ARH-77	Binding and Uptake of Ligands by Scavenger Receptors
Ig heavy chain V-II region SESS	Binding and Uptake of Ligands by Scavenger Receptors
Ig heavy chain V-III region WEA	Binding and Uptake of Ligands by Scavenger Receptors
Ig heavy chain V-III region TRO	Binding and Uptake of Ligands by Scavenger Receptors
Ig heavy chain V-III region BUR	Binding and Uptake of Ligands by Scavenger Receptors
Ig heavy chain V-III region KOL	Binding and Uptake of Ligands by Scavenger Receptors
Ig heavy chain V-III region LAY	Binding and Uptake of Ligands by Scavenger Receptors
Ig heavy chain V-III region POM	Binding and Uptake of Ligands by Scavenger Receptors
Ig heavy chain V-III region GA	Binding and Uptake of Ligands by Scavenger Receptors
Ig heavy chain V-III region CAM	Binding and Uptake of Ligands by Scavenger Receptors
Ig heavy chain V-III region HIL	Binding and Uptake of Ligands by Scavenger Receptors
Ig heavy chain V-III region NIE	Binding and Uptake of Ligands by Scavenger Receptors
Ig heavy chain V-I region Mot	Binding and Uptake of Ligands by Scavenger Receptors
Ig heavy chain V-I region WOL	Binding and Uptake of Ligands by Scavenger Receptors
Ig heavy chain V-I region SIE	Binding and Uptake of Ligands by Scavenger Receptors
Ig heavy chain V-I region HG3	Binding and Uptake of Ligands by Scavenger Receptors
Ig heavy chain V-I region ND	Binding and Uptake of Ligands by Scavenger Receptors
UROC1	Metabolism
Ig heavy chain V-I region EU	Binding and Uptake of Ligands by Scavenger Receptors
Ig heavy chain V-II region WAH	Binding and Uptake of Ligands by Scavenger Receptors
Ig heavy chain V-II region NEWM	Binding and Uptake of Ligands by Scavenger Receptors
Ig heavy chain V-II region MCE	Binding and Uptake of Ligands by Scavenger Receptors
Ig heavy chain V-II region HE	Binding and Uptake of Ligands by Scavenger Receptors
Ig heavy chain V-II region COR	Binding and Uptake of Ligands by Scavenger Receptors
Ig heavy chain V-II region DAW	Binding and Uptake of Ligands by Scavenger Receptors
Ig heavy chain V-II region OU	Binding and Uptake of Ligands by Scavenger Receptors
HAL	Metabolism
TCF12	Developmental Biology
TRIM32	Immune System
NDST2	Disease
NDST1	Disease
HYAL2	Disease
HK2	Disease
HK3	Disease
EPHX2	Metabolism
SPAM1	Reproduction
CASP1	Immune System
TIMM13	Metabolism of proteins
HK1	Disease
ID1	Cellular responses to stress
ICOSLG	Immune System
IRF8	Immune System
CLNS1A	Gene Expression
CASP10	Apoptosis
CASP8	Apoptosis
CASP9	Apoptosis
CASP6	Apoptosis
CASP7	Apoptosis
CASP4	Immune System
IFI16	Immune System
IDUA	Disease
IDS	Disease
IDI2	Metabolism
IDI1	Metabolism
IDH2	Metabolism
IDH3G	Metabolism
IDH1	Disease
IDH3B	Metabolism
IDH3A	Metabolism
IAPP	Developmental Biology
INPP5A	Metabolism
INPP5B	Metabolism
INSM1	Developmental Biology
IDO1	Metabolism
AGO1	Cellular responses to stress
CASP3	Apoptosis
ICAM3	Extracellular matrix organization
SERPING1	Hemostasis
IGFBP7	Cellular responses to stress
ICAM2	Extracellular matrix organization
ICAM1	Extracellular matrix organization
IFITM1	Immune System
IFITM3	Immune System
IFITM2	Immune System
IFIT3	Immune System
IFIT2	Immune System
IFIT1	Immune System
IGF1R	Signal Transduction
GIF	Disease
IGF1	Hemostasis
INHBB	Signal Transduction
INHBA	Signal Transduction
NFKBIE	Immune System
CHUK	Disease
NFKBIA	Immune System
NFKBIB	Immune System
EIF5B	Gene Expression
EIF4A3	Gene Expression
FABP6	Metabolism
CXCR2	Signal Transduction
CXCR1	Signal Transduction
IL7	Immune System
IL7R	Immune System
TIMM10	Metabolism of proteins
ILK	Cell-Cell communication
TIMM8A	Metabolism of proteins
TIMM8B	Metabolism of proteins
TIMM17A	Metabolism of proteins
TIMM17B	Metabolism of proteins
TIMM23	Metabolism of proteins
TIMM44	Metabolism of proteins
TIMM22	Metabolism of proteins
KPNA5	Immune System
KPNB1	Apoptosis
KPNA3	Immune System
KPNA4	Immune System
KPNA1	Apoptosis
KPNA2	Immune System
TIMM9	Metabolism of proteins
TIMM10B	Metabolism of proteins
IKBKE	Immune System
IKBKB	Immune System
IL1R2	Immune System
IL1R1	Immune System
IL1RN	Immune System
IL18	Immune System
IL1B	Immune System
IL1A	Cellular responses to stress
IL2RB	Immune System
IL2	Immune System
IL3RA	Immune System
IL2RA	Immune System
IL5	Immune System
IL6R	Immune System
IL6ST	Immune System
IL6	Cellular responses to stress
IL3	Immune System
IL5RA	Immune System
GNA13	Hemostasis
GNA12	Hemostasis
GNA11	Hemostasis
GNAO1	Signal Transduction
GATM	Metabolism
GATA6	Hemostasis
GATA5	Hemostasis
GATA4	Hemostasis
GATA3	Hemostasis
GATA2	Hemostasis
GATA1	Hemostasis
GAST	Signal Transduction
CCKBR	Signal Transduction
GAS2	Apoptosis
GABRR2	Neuronal System
GAN	Immune System
GABRR1	Neuronal System
GAMT	Metabolism
GALR2	Signal Transduction
GALR3	Signal Transduction
GALR1	Signal Transduction
GALC	Metabolism
GALE	Disease
GALT	Disease
GAL	Signal Transduction
GNG10	Hemostasis
GNG8	Hemostasis
GNG11	Hemostasis
GNG7	Hemostasis
GNG5	Hemostasis
GNG4	Hemostasis
GNGT1	Disease
GBF1	Membrane Trafficking
GNG3	Hemostasis
GNB3	Hemostasis
GNB4	Hemostasis
GNB5	Disease
GNB2	Hemostasis
GNAS	Hemostasis
GNAZ	Signal Transduction
GNB1	Disease
GNA14	Hemostasis
GNA15	Hemostasis
GNAL	Neuronal System
GNAI3	Hemostasis
GUCA1A	Disease
BLOC1S1	Membrane Trafficking
IGHG4	Immune System
IGHG3	Immune System
GCDH	Metabolism
GUCA1C	Disease
GUCA1B	Disease
GNAT2	Signal Transduction
GNAT1	Disease
GABBR2	Neuronal System
GABBR1	Neuronal System
IGHG2	Immune System
IGHG1	Immune System
GBP2	Immune System
GNAQ	Hemostasis
GBP1	Immune System
GNG13	Hemostasis
GNGT2	Hemostasis
GNG12	Hemostasis
GNAI2	Hemostasis
GNAI1	Hemostasis
ARHGDIA	Signal Transduction
ARHGDIB	Signal Transduction
GFRA1	Developmental Biology
GDNF	Developmental Biology
GDF1	Developmental Biology
AGL	Disease
GDF5	Extracellular matrix organization
TUBGCP6	Cell Cycle
NR3C1	Gene Expression
MOGS	Metabolism of proteins
SLC25A16	Disease
GCH1	Metabolism
GCKR	Disease
TUBGCP2	Cell Cycle
TUBGCP3	Cell Cycle
TUBGCP4	Cell Cycle
TUBGCP5	Cell Cycle
GOLGA2	Cell Cycle
GCHFR	Metabolism
GSN	Apoptosis
SERPINE2	Hemostasis
GFAP	Signal Transduction
GFPT2	Metabolism of proteins
GFPT1	Metabolism of proteins
GPHN	Disease
GK2	Metabolism
GK3P	Metabolism
GNS	Disease
GLCE	Disease
GIPR	Signal Transduction
GIP	Metabolism of proteins
CGA	Metabolism of proteins
GBA	Metabolism
GBE1	Disease
GGT2	Metabolism
GGT1	Metabolism
GGT5	Metabolism
GGPS1	Metabolism
TSC22D3	Transmembrane transport of small molecules
IFI30	Immune System
ZNF461	Gene Expression
GHR	Immune System
GHSR	Signal Transduction
GK	Metabolism
GCGR	Metabolism
GLS	Metabolism
GRIA4	Neuronal System
GLRX	Metabolism
GCG	Metabolism
GLS2	Metabolism
GRIK2	Neuronal System
GRIK1	Neuronal System
GLIPR1	Metabolism
GRIK5	Neuronal System
GRIK4	Neuronal System
GRIK3	Neuronal System
GLUL	Metabolism
GLP2R	Signal Transduction
MGAT1	Metabolism of proteins
MGAT2	Metabolism of proteins
MGAT3	Metabolism of proteins
MGAT5	Metabolism of proteins
GNRH1	Signal Transduction
GNRH2	Signal Transduction
PRLHR	Signal Transduction
GPR17	Signal Transduction
GPR18	Signal Transduction
GYG1	Disease
SHMT1	Disease
CSF2RA	Immune System
GMPR2	Metabolism
GMPR	Metabolism
RALGDS	Signal Transduction
FFAR3	Signal Transduction
FFAR2	Signal Transduction
PTGDR2	Signal Transduction
GPR39	Signal Transduction
FFAR1	Metabolism
GPR31	Signal Transduction
MCHR1	Signal Transduction
GPC1	Developmental Biology
GP1BB	Hemostasis
GPC4	Disease
GPC3	Disease
GP1BA	Hemostasis
GPR68	Signal Transduction
GP5	Hemostasis
DPAGT1	Metabolism of proteins
NPBWR1	Signal Transduction
NPBWR2	Signal Transduction
GPR4	Signal Transduction
PIGK	Metabolism of proteins
GP9	Hemostasis
GPD1	Metabolism
GPD2	Metabolism
GPC5	Disease
GPC6	Disease
GRB10	Signal Transduction
GRB7	Hemostasis
GRAP	Signal Transduction
GZMM	Immune System
GZMH	Metabolism of proteins
GZMB	Apoptosis
GLRA3	Transmembrane transport of small molecules
GLRA2	Transmembrane transport of small molecules
GLRA1	Transmembrane transport of small molecules
HSPA5	Hemostasis
HSPA9	Metabolism of proteins
GNRHR	Signal Transduction
GRK5	Signal Transduction
CXCL1	Signal Transduction
GRAP2	Immune System
GRB14	Hemostasis
GLRB	Transmembrane transport of small molecules
GRPEL1	Metabolism of proteins
GRPEL2	Metabolism of proteins
GHRHR	Signal Transduction
GCLM	Metabolism
GCLC	Metabolism
GPX1	Cellular responses to stress
GSS	Metabolism
GRP	Signal Transduction
GRPR	Signal Transduction
GNRHR2	Signal Transduction
GOSR2	Metabolism of proteins
MGST1	Metabolism
SLC2A10	Transmembrane transport of small molecules
MGST2	Metabolism
MGST3	Metabolism
GPX4	Metabolism
GPX2	Cellular responses to stress
TECR	Metabolism
GSTM3	Metabolism
GSTM2	Metabolism
GSTM1	Metabolism
GSTP1	Cellular responses to stress
GSTO1	Disease
GSTM5	Metabolism
GSTA2	Metabolism
GSTA1	Metabolism
SLC2A11	Transmembrane transport of small molecules
GSTA4	Metabolism
GSTA3	Metabolism
SLC2A6	Transmembrane transport of small molecules
SLC2A5	Disease
SLC2A9	Transmembrane transport of small molecules
SLC2A8	Transmembrane transport of small molecules
SLC2A2	Developmental Biology
SLC2A1	Disease
SLC2A4	Developmental Biology
SLC2A3	Disease
GDA	Metabolism
GYG2	Disease
GSTT1	Metabolism
GMPS	Metabolism
HIST1H1A	Apoptosis
HIST1H1C	Apoptosis
HIST1H1D	Apoptosis
HIST1H1E	Apoptosis
GYS1	Disease
GYS2	Disease
HSPH1	Binding and Uptake of Ligands by Scavenger Receptors
H1F0	Apoptosis
HIST1H1B	Apoptosis
HIST1H2AB	Cell Cycle
HIST1H2AC	Cell Cycle
HIST1H2AD	Cell Cycle
HIST1H2AJ	Cell Cycle
H2AFX	Cell Cycle
HIST2H2AC	Cell Cycle
HIST1H2BN	Cell Cycle
HIST1H2BM	Cell Cycle
HIST1H2BD	Cell Cycle
HIST1H2BL	Cell Cycle
HIST1H2BC	Cell Cycle
HIST1H2BJ	Cell Cycle
H2BFS	Cell Cycle
HIST1H2BO	Cell Cycle
HIST2H2BE	Cell Cycle
HIST1H2BH	Cell Cycle
HIST1H2BB	Cell Cycle
HIST3H3	Cell Cycle
HLA-DQA1	Immune System
HLA-DPA1	Immune System
HLA-DQA2	Immune System
HLA-DOA	Immune System
HLA-DRA	Immune System
HAO1	Metabolism
HAS1	Disease
HAS2	Disease
HAS3	Disease
HLA-DQB1	Immune System
ETS2	Cellular responses to stress
ETS1	Cellular responses to stress
EVL	Developmental Biology
ESR2	Gene Expression
EDNRA	Signal Transduction
ESPL1	Cell Cycle
EDNRB	Signal Transduction
ETFA	Metabolism
ETFB	Metabolism
EDN1	Signal Transduction
EDN2	Signal Transduction
EDN3	Signal Transduction
LSS	Metabolism
SQLE	Metabolism
ERF	Cellular responses to stress
ETF1	Gene Expression
EREG	Disease
ESRRG	Gene Expression
ESRRB	Gene Expression
ESRRA	Gene Expression
TM7SF2	Metabolism
MSMO1	Metabolism
KDELR3	Metabolism of proteins
MVD	Metabolism
ERCC1	DNA Repair
ERCC6	DNA Repair
ERBB2	Developmental Biology
LMAN1	Metabolism of proteins
IGHE	Immune System
EPO	Cellular responses to stress
SLC29A1	Transmembrane transport of small molecules
SLC29A2	Transmembrane transport of small molecules
CCL11	Signal Transduction
EPS15	Disease
ENO2	Disease
ENO3	Disease
ENO1	Disease
ENSA	Cell Cycle
HSP90B1	Binding and Uptake of Ligands by Scavenger Receptors
ELN	Extracellular matrix organization
ELAVL1	Gene Expression
EMD	Cell Cycle
EMR1	Signal Transduction
FGF9	Disease
FGF10	Disease
FGF4	Disease
FGF6	Disease
FGF7	Disease
FGD1	Signal Transduction
FGF1	Disease
FGF2	Developmental Biology
FGF3	Disease
FES	Developmental Biology
FER	Signal Transduction
SLC35C1	Transmembrane transport of small molecules
FCN3	Immune System
FDFT1	Metabolism
FCN2	Immune System
FCN1	Immune System
FCGR2B	Immune System
FCGR2A	Immune System
FCER1G	Hemostasis
FCGR1A	Immune System
FCER1A	Immune System
MS4A2	Immune System
FCER2	Signal Transduction
FCGR3A	Immune System
FBXO6	Immune System
FBXO4	Immune System
FBXO5	Cell Cycle
FBXO2	Immune System
FBXO3	Immune System
FBXW4	Metabolism of proteins
FBXW2	Metabolism of proteins
FBN2	Extracellular matrix organization
FBN1	Extracellular matrix organization
FBLN5	Extracellular matrix organization
EFEMP2	Extracellular matrix organization
EFEMP1	Extracellular matrix organization
FBLN2	Extracellular matrix organization
FBLN1	Extracellular matrix organization
FASN	Disease
FADD	Apoptosis
USP9X	Disease
PTK2	Apoptosis
PTK2B	Cell-Cell communication
FABP1	Metabolism
FANCA	DNA Repair
FANCC	DNA Repair
FANCF	DNA Repair
FANCG	DNA Repair
F9	Hemostasis
FAH	Metabolism
FABP4	Developmental Biology
F5	Hemostasis
F8	Hemostasis
F7	Circadian Clock
PFKFB3	Disease
PFKFB4	Disease
CAMP	Disease
F11	Hemostasis
F12	Hemostasis
F13A1	Hemostasis
F13B	Hemostasis
PFKFB1	Disease
PFKFB2	Disease
FBP1	Disease
FBP2	Disease
EXT2	Disease
EZR	Developmental Biology
EZH2	Cellular responses to stress
EXT1	Disease
EXTL3	Metabolism of proteins
FTH1	Binding and Uptake of Ligands by Scavenger Receptors
FTL	Binding and Uptake of Ligands by Scavenger Receptors
FXN	Metabolism
MTOR	Cellular responses to stress
FST	Signal Transduction
FRAT2	Signal Transduction
FRAT1	Signal Transduction
FTCD	Metabolism
CENPI	Cell Cycle
FSTL3	Signal Transduction
FSTL1	Signal Transduction
FSHR	Signal Transduction
FSHB	Metabolism of proteins
FUS	Gene Expression
FURIN	Developmental Biology
FH	Metabolism
FPR1	Signal Transduction
FMO1	Metabolism
FPR2	Signal Transduction
FPR3	Signal Transduction
FMOD	Disease
FMO2	Metabolism
FMO3	Metabolism
FDPS	Metabolism
FOS	Cellular responses to stress
FN1	Extracellular matrix organization
IL4I1	Disease
FKBP14	Metabolism of proteins
FKBP1A	Disease
FKBP6	Cell Cycle
FKBP9	Metabolism of proteins
ALOX5AP	Metabolism
SLC19A1	Disease
FLNA	Cell-Cell communication
BLVRB	Metabolism
FGF16	Disease
FGF18	Disease
FGF19	Disease
FGF20	Disease
FGF22	Disease
FGF23	Disease
FGFR1	Developmental Biology
FGFR3	Disease
FGFR2	Disease
FGR	Hemostasis
FGFR4	Disease
CFHR3	Immune System
FGB	Extracellular matrix organization
FGA	Disease
FGG	Extracellular matrix organization
GABRB2	Neuronal System
GABRB1	Neuronal System
GABRA6	Neuronal System
GABRA5	Neuronal System
GABRA4	Neuronal System
GABRA3	Neuronal System
GABRA2	Neuronal System
GABRA1	Neuronal System
DDIT3	Metabolism of proteins
GALK1	Disease
GAK	Membrane Trafficking
GABRG2	Neuronal System
GABRG3	Neuronal System
ABAT	Neuronal System
GABRB3	Neuronal System
G0S2	Metabolism
PRKCSH	Immune System
FZD7	Signal Transduction
FZD6	Signal Transduction
FZD9	Signal Transduction
FZD8	Signal Transduction
FZD3	Signal Transduction
FZD2	Signal Transduction
FZD5	Signal Transduction
FZD4	Signal Transduction
GPI	Disease
G6PC	Disease
GCNT1	Metabolism of proteins
G6PD	Disease
GAPDH	Disease
GAPDHS	Disease
FOXM1	Cell Cycle
FOXH1	Developmental Biology
FYB	Cell-Cell communication
FXYD6	Transmembrane transport of small molecules
FXYD7	Transmembrane transport of small molecules
FZD10	Signal Transduction
FZD1	Signal Transduction
FYN	Cell-Cell communication
PIKFYVE	Metabolism
FXYD3	Transmembrane transport of small molecules
FBXW11	Cell Cycle
BTRC	Cell Cycle
FBXO44	Immune System
FBXO17	Immune System
KDSR	Metabolism
FUT8	Metabolism of proteins
GNPAT	Metabolism
DAPK1	Apoptosis
DBP	Circadian Clock
DRD5	Signal Transduction
DCC	Apoptosis
AMD1	Metabolism
HIBADH	Metabolism
DRD4	Signal Transduction
ECI1	Metabolism
DRD3	Signal Transduction
ALDH7A1	Metabolism
DAD1	Metabolism of proteins
CD55	Immune System
DAG1	Extracellular matrix organization
DRD1	Signal Transduction
DDB1	DNA Repair
DDC	Metabolism
DDB2	DNA Repair
DDR2	Extracellular matrix organization
GAD1	Neuronal System
GAD2	Neuronal System
HDC	Metabolism
DCK	Metabolism
MLYCD	Metabolism
ODC1	Metabolism
DCTD	Metabolism
UROD	Metabolism
DCX	Developmental Biology
PPIA	Disease
PPIB	Extracellular matrix organization
PPIL2	Hemostasis
CYCS	Apoptosis
MT-CYB	Metabolism
ADCY9	Disease
CYB5A	Disease
GUCY2D	Disease
GUCY2F	Disease
GUCY1A2	Hemostasis
GUCY1B2	Hemostasis
GUCY1A3	Hemostasis
CDO1	Metabolism
GUCY1B3	Hemostasis
DEFB118	Immune System
DEFB108B	Immune System
DEFB119	Immune System
DEFB103A	Immune System
DEFB106A	Immune System
DEFB104A	Immune System
DEFB129	Immune System
DRD2	Signal Transduction
DEFB125	Immune System
DEFB123	Immune System
DEFB127	Immune System
DEFB126	Immune System
CSF2RB	Immune System
IL2RG	Immune System
CST3	Disease
DNAJB11	Metabolism of proteins
DNAJB9	Metabolism of proteins
SLC25A10	Amino acid and oligopeptide SLC transporters
DICER1	Gene Expression
SDHA	Metabolism
QDPR	Metabolism
DHPS	Metabolism of proteins
SDHD	Metabolism
SDHB	Metabolism
DLG4	Developmental Biology
DLK1	Disease
DLL1	Disease
DLL4	Disease
DNAL4	Signal Transduction
DLG1	Developmental Biology
DLD	Metabolism
DLG3	Developmental Biology
DNAJC5	Neuronal System
DNAJC8	Gene Expression
DKC1	Cell Cycle
DFFA	Apoptosis
DFFB	Apoptosis
DSP	Apoptosis
DES	Muscle contraction
DEFA6	Immune System
DEFA5	Immune System
DEFA4	Immune System
DECR1	Metabolism
DHX9	Gene Expression
DDX6	Gene Expression
HSD11B1	Metabolism
DHCR7	Metabolism
CBR1	Metabolism
DHCR24	Metabolism
GLUD1	Metabolism
HSD17B4	Metabolism
HSD17B1	Disease
HSD17B3	Metabolism
ALDH2	Metabolism
ALDH9A1	Metabolism
ALDH1A1	Metabolism
DGAT1	Metabolism
DGUOK	Metabolism
DNASE2	Membrane Trafficking
DSCAM	Cell-Cell communication
DSG1	Apoptosis
DSG3	Apoptosis
DSG2	Apoptosis
DSPP	Extracellular matrix organization
PIGP	Metabolism of proteins
IGHD	Immune System
SLC26A2	Disease
DARC	Signal Transduction
DUSP3	Immune System
DUSP4	Immune System
DUSP7	Immune System
DVL2	Signal Transduction
DYNC1H1	Cell Cycle
DYNC1I2	Cell Cycle
DYNC1I1	Immune System
DMC1	Cell Cycle
DMD	Extracellular matrix organization
LIG1	Cell Cycle
LIG3	DNA Repair
DMP1	Extracellular matrix organization
DOK1	Signal Transduction
DOK2	Hemostasis
LIG4	DNA Repair
DBH	Metabolism
DPM1	Metabolism of proteins
DPM2	Metabolism of proteins
POLB	DNA Repair
DPM3	Metabolism of proteins
DPYSL2	Developmental Biology
CRMP1	Developmental Biology
DPP4	Metabolism of proteins
SLC26A3	Transmembrane transport of small molecules
DPYS	Metabolism
DPYD	Metabolism
DPYSL5	Developmental Biology
DPYSL4	Developmental Biology
DPYSL3	Developmental Biology
EEF1A1	Gene Expression
PHC1	Cellular responses to stress
EEF1B2	Gene Expression
EEF1A2	Gene Expression
EEF1G	Gene Expression
EEF1D	Gene Expression
S1PR1	Signal Transduction
S1PR3	Signal Transduction
LPAR1	Signal Transduction
LPAR3	Signal Transduction
LPAR2	Signal Transduction
EEF2K	Signal Transduction
EEF2	Gene Expression
EHD3	Hemostasis
EHD2	Hemostasis
ETNK2	Metabolism
ETNK1	Metabolism
EGR1	Immune System
EGF	Disease
EGFR	Developmental Biology
EHD1	Hemostasis
ELMO1	Disease
ELANE	Extracellular matrix organization
ELL	Disease
ELOVL3	Circadian Clock
ELOVL4	Metabolism
ELOVL1	Metabolism
ELOVL2	Metabolism
DYRK1A	Cell Cycle
DNM1	Developmental Biology
DNM3	Developmental Biology
DYNLL1	Apoptosis
DYNC1LI2	Immune System
EIF2AK2	Disease
DHFR	Cell Cycle
EBP	Metabolism
NR2F6	Gene Expression
SLC1A3	Amino acid and oligopeptide SLC transporters
EPB41L1	Neuronal System
MMRN1	Hemostasis
HADHB	Metabolism
ECHS1	Metabolism
HADHA	Metabolism
PLA2G2A	Metabolism
PLA2G6	Immune System
PLA2G2E	Metabolism
PLA2G2D	Metabolism
PLA2G2F	Metabolism
PLA2G12A	Metabolism
PLA2G10	Metabolism
PIK3R1	Cell-Cell communication
PIK3R2	Cell-Cell communication
PLA2G1B	Metabolism
PLA2G3	Metabolism
PLA2G4A	Hemostasis
PLA2G5	Metabolism
PAK7	Developmental Biology
PAK6	Developmental Biology
PANX1	Immune System
PANX2	Neuronal System
F2R	Hemostasis
ADCYAP1	Signal Transduction
PLA2G7	Metabolism of proteins
ADCYAP1R1	Signal Transduction
PPY	Signal Transduction
PHYH	Metabolism
PTAFR	Immune System
GALNT1	Metabolism of proteins
PAK1	Cell-Cell communication
PAK2	Apoptosis
SERPINE1	Circadian Clock
SERPINB2	Hemostasis
NAMPT	Circadian Clock
PXN	Cell-Cell communication
KAT2B	Chromatin organization
PARVB	Cell-Cell communication
EPAS1	Cellular responses to stress
F2RL1	Signal Transduction
F2RL2	Hemostasis
F2RL3	Hemostasis
PARVA	Cell-Cell communication
PDIA3	Immune System
PTGDR	Signal Transduction
PCYT2	Metabolism
PRCP	Hemostasis
PCOLCE	Extracellular matrix organization
PDGFB	Disease
PDGFA	Disease
PDIA5	Metabolism of proteins
PCCB	Disease
PDCD1	Immune System
PCCA	Disease
PCNT	Cell Cycle
PCSK5	Signal Transduction
HCRT	Signal Transduction
OSBPL1A	Immune System
OPN1MW	Disease
OPN1LW	Disease
RRH	Signal Transduction
OPN4	Signal Transduction
OPN3	Signal Transduction
OPRK1	Signal Transduction
OPRD1	Signal Transduction
OPRL1	Signal Transduction
OPRM1	Signal Transduction
RHO	Disease
OPN1SW	Disease
OPHN1	Signal Transduction
OPLAH	Metabolism
ARHGAP26	Signal Transduction
OR51B2	Signal Transduction
OR51B4	Signal Transduction
HCRTR2	Signal Transduction
OR51E2	Signal Transduction
OR51I1	Signal Transduction
DAO	Metabolism
OTC	Metabolism
HCRTR1	Signal Transduction
CD200	Immune System
SPP1	Extracellular matrix organization
DDOST	Gene Expression
SLC25A2	Metabolism
SLC25A15	Metabolism
PPP3CC	Apoptosis
PPM1A	Disease
PPP2CB	Cell Cycle
PPP3CA	Calcineurin dephosphorylates NFATC1,2,3
PPP2CA	Cell Cycle
PIK3CG	Hemostasis
PIK3CA	Cell-Cell communication
PIK3CD	Disease
PIK3CB	Cell-Cell communication
OR52B2	Signal Transduction
OR52A1	Signal Transduction
OR52E6	Signal Transduction
OR52D1	Signal Transduction
OR51M1	Signal Transduction
OR51I2	Signal Transduction
OXTR	Signal Transduction
HYOU1	Binding and Uptake of Ligands by Scavenger Receptors
PIK3R3	Disease
TP53BP1	DNA Repair
EP300	Cell Cycle
P2RY1	Hemostasis
P2RY14	Signal Transduction
P2RY11	Signal Transduction
P2RY12	Hemostasis
LPAR4	Signal Transduction
P2RY10	Signal Transduction
P2RY6	Signal Transduction
LPAR6	Signal Transduction
P2RY4	Signal Transduction
P2RY2	Signal Transduction
P2RX7	Immune System
P2RX1	Hemostasis
OR1A2	Signal Transduction
OR1C1	Signal Transduction
OR1A1	Signal Transduction
OR1D5	Signal Transduction
OR1E1	Signal Transduction
OR1D2	Signal Transduction
OR1D4	Signal Transduction
OR1F1	Signal Transduction
OR1G1	Signal Transduction
OR1E2	Signal Transduction
OR2A4	Signal Transduction
OR2B2	Signal Transduction
OR1I1	Signal Transduction
OR1Q1	Signal Transduction
OR2D2	Signal Transduction
OR2C1	Signal Transduction
OR2B6	Signal Transduction
OR2B3	Signal Transduction
OR2H1	Signal Transduction
OR2AG1	Signal Transduction
OR2F2	Signal Transduction
OR2F1	Signal Transduction
OR2J3	Signal Transduction
OR2J2	Signal Transduction
OR2H2	Signal Transduction
OR3A1	Signal Transduction
OR2W1	Signal Transduction
OR2T1	Signal Transduction
OR2S2	Signal Transduction
OR3A2	Signal Transduction
OR3A3	Signal Transduction
OR3A4P	Signal Transduction
OR4D1	Signal Transduction
OR4D2	Signal Transduction
OR4F21	Signal Transduction
OR5B2	Signal Transduction
OR5B12	Signal Transduction
OR5F1	Signal Transduction
OR5I1	Signal Transduction
OR5P2	Signal Transduction
OR5P3	Signal Transduction
OR14J1	Signal Transduction
OR5V1	Signal Transduction
OR6A2	Signal Transduction
OR6B1	Signal Transduction
OR7A10	Signal Transduction
OR7A5	Signal Transduction
OR7C1	Signal Transduction
OR7A17	Signal Transduction
OR8B2	Signal Transduction
OR7C2	Signal Transduction
OR8B8	Signal Transduction
OR8B4	Signal Transduction
OR8D2	Signal Transduction
OR8D1	Signal Transduction
OR10A4	Signal Transduction
OR10A3	Signal Transduction
OAS1	Immune System
OAS2	Immune System
OR10H3	Signal Transduction
OR10J1	Signal Transduction
OR10H1	Signal Transduction
OR10H2	Signal Transduction
OR10A5	Signal Transduction
OR10C1	Signal Transduction
OR11A1	Signal Transduction
OAZ3	Metabolism
OAZ1	Metabolism
OAT	Metabolism
OAZ2	Metabolism
OAS3	Immune System
OASL	Immune System
OCLN	Apoptosis
OR12D3	Signal Transduction
OR12D2	Signal Transduction
LEP	Developmental Biology
AZIN1	Metabolism
BCKDHB	Metabolism
BCKDHA	Metabolism
DBT	Metabolism
CROT	Metabolism
SLC22A3	Metabolism
SLC22A5	Transmembrane transport of small molecules
DLAT	Metabolism
PDHA1	Metabolism
PDHB	Metabolism
SLC25A21	Metabolism
OGDH	Metabolism
DLST	Metabolism
OGG1	DNA Repair
OVGP1	Reproduction
OIP5	Cell Cycle
PDHX	Metabolism
OFD1	Cell Cycle
POFUT1	Signal Transduction
TOMM20	Metabolism of proteins
TOMM7	Metabolism of proteins
OMG	Signal Transduction
OMD	Disease
TOMM22	Metabolism of proteins
TOMM70A	Metabolism of proteins
TOMM40	Metabolism of proteins
NR4A2	Gene Expression
NR4A1	Disease
NR1D1	Circadian Clock
SLC17A3	Transmembrane transport of small molecules
NR2E1	Gene Expression
NQO1	Metabolism
CHRDL1	Signal Transduction
SLC11A2	Transmembrane transport of small molecules
SLC11A1	Disease
NRF1	Metabolism
NR1D2	Gene Expression
NRG4	Disease
NR1H2	Gene Expression
NRG2	Disease
NRG3	Disease
NSF	Neuronal System
NSDHL	Metabolism
SMPD2	Metabolism
NRTN	Developmental Biology
NOS2	Disease
GFRA2	Developmental Biology
SLC10A2	Metabolism
SLC10A1	Metabolism
NTHL1	DNA Repair
NTSR1	Signal Transduction
NTSR2	Signal Transduction
NOTCH1	A third proteolytic cleavage releases NICD
NOTCH2	A third proteolytic cleavage releases NICD
NOTCH3	A third proteolytic cleavage releases NICD
NOTCH4	A third proteolytic cleavage releases NICD
NUP88	Cell Cycle
MT-ND6	Metabolism
NUP62	Cell Cycle
MT-ND5	Metabolism
NUP50	Cell Cycle
MT-ND4	Metabolism
NUP43	Cell Cycle
MT-ND3	Metabolism
NUP37	Cell Cycle
MT-ND2	Metabolism
MT-ND1	Metabolism
SLC6A15	Amine compound SLC transporters
NDUFS3	Metabolism
NDUFV2	Metabolism
NDUFA5	Metabolism
NDUFA10	Metabolism
NDUFA9	Metabolism
NDUFS2	Metabolism
NUDT5	Metabolism
NUBP2	Metabolism
NDUFV1	Metabolism
NDUFS1	Metabolism
NUBP1	Metabolism
NRXN1	Extracellular matrix organization
NDUFS4	Metabolism
NDUFA8	Metabolism
NDUFA4	Metabolism
NUMB	Developmental Biology
NDUFV3	Metabolism
NDUFS6	Metabolism
NDUFS7	Metabolism
NDUFS8	Metabolism
MT-ND4L	Metabolism
NPY1R	Signal Transduction
NPY2R	Signal Transduction
NPY4R	Signal Transduction
NPY5R	Signal Transduction
KLRK1	Immune System
KLRC2	Immune System
NKX6-1	Developmental Biology
BAMBI	Disease
SCP2	Metabolism
SLC24A3	Transmembrane transport of small molecules
SLC24A2	Transmembrane transport of small molecules
SLC24A1	Disease
TACR1	Signal Transduction
NKX2-2	Developmental Biology
NDUFB5	Metabolism
NDUFS5	Metabolism
TACR3	Signal Transduction
TACR2	Signal Transduction
CTDSP2	Metabolism of proteins
NDUFB2	Metabolism
NDUFB10	Metabolism
NID2	Extracellular matrix organization
NID1	Extracellular matrix organization
TRIB3	Disease
NDUFC1	Metabolism
NDUFB1	Metabolism
NDUFA1	Metabolism
NEUROG3	Developmental Biology
NGF	Signal Transduction
NDUFB9	Metabolism
NDUFA2	Metabolism
NDUFA3	Metabolism
NDUFB8	Metabolism
NPHP4	Signal Transduction
ENPP1	Disease
SLC34A1	Transmembrane transport of small molecules
SLC17A1	Amino acid and oligopeptide SLC transporters
NOS3	Disease
NPAS2	Circadian Clock
NPFF	Signal Transduction
NOP56	Metabolism of proteins
NODAL	Developmental Biology
CCRN4L	Circadian Clock
NOG	Signal Transduction
NMBR	Signal Transduction
GRIN2A	Neuronal System
GRIN2B	Neuronal System
GRIN2C	Neuronal System
GRIN2D	Neuronal System
NMT1	Apoptosis
NMT2	Disease
GRIN1	Neuronal System
NNMT	Metabolism
NNT	Metabolism
NME2	Metabolism
NME4	Metabolism
NME1	Metabolism
NEUROD1	Developmental Biology
PDYN	Signal Transduction
NCKAP1	Immune System
NCOA2	Developmental Biology
NCK2	Cell-Cell communication
NCK1	Cell-Cell communication
NCF4	Disease
NCF1	Disease
NCF2	Disease
NCAM1	Developmental Biology
NCALD	Neuronal System
COASY	Disease
CYB5R3	Disease
NDUFA13	Metabolism
NDUFB6	Metabolism
NDUFB7	Metabolism
NDUFB3	Metabolism
NDUFB4	Metabolism
NDUFA6	Metabolism
ART1	Immune System
NLRP4	Immune System
NEFL	Neuronal System
NPFFR1	Signal Transduction
NPFFR2	Signal Transduction
NFATC1	Calcineurin dephosphorylates NFATC1,2,3
NPY	Signal Transduction
NFE2	Hemostasis
NFATC3	Calcineurin dephosphorylates NFATC1,2,3
NFATC2	Calcineurin dephosphorylates NFATC1,2,3
NTS	Signal Transduction
NMU	Signal Transduction
NTN1	Cell-Cell communication
OXT	Signal Transduction
AVP	Circadian Clock
NMB	Signal Transduction
IKBKG	Immune System
NEO1	Developmental Biology
MME	Metabolism of proteins
NEU1	Metabolism
NEU2	Metabolism
NEU3	Metabolism
NEDD4	Immune System
NEDD8	Disease
NEB	Muscle contraction
PCSK2	Metabolism of proteins
PCSK1	Metabolism of proteins
MOV10	Cellular responses to stress
MX1	Immune System
MX2	Immune System
IGHM	Immune System
MUT	Disease
MYO1C	Immune System
MYO10	Developmental Biology
MYD88	Immune System
MYO5B	Transmembrane transport of small molecules
SLC2A13	Transmembrane transport of small molecules
MYC	Disease
MYB	Hemostasis
MTM1	Metabolism
MLNR	Signal Transduction
MTHFR	Disease
MTMR2	Metabolism
MTMR3	Metabolism
MTTP	Metabolism
MTMR1	Metabolism
MATN3	Extracellular matrix organization
MATN4	Extracellular matrix organization
MTX2	Metabolism of proteins
MTX1	Metabolism of proteins
MTERF	Gene Expression
MTRR	Disease
MTMR7	Metabolism
MTMR6	Metabolism
MUC3A	Metabolism of proteins
MUC2	Metabolism of proteins
MUC1	Metabolism of proteins
MUC5B	Metabolism of proteins
MUC5AC	Metabolism of proteins
MYBPC1	Muscle contraction
NUP107	Cell Cycle
NUP153	Cell Cycle
NUP214	Cell Cycle
TUSC3	Metabolism of proteins
NDUFA7	Metabolism
NDUFC2	Metabolism
NDUFA12	Metabolism
SLC8A2	Hemostasis
SLC8A1	Hemostasis
QPRT	Disease
SLC8A3	Hemostasis
NGFRAP1	Signal Transduction
SLC9A1	Disease
SLC9A3	Transmembrane transport of small molecules
SLC9A2	Transmembrane transport of small molecules
SLC9A6	Transmembrane transport of small molecules
SLC9A5	Transmembrane transport of small molecules
NLRP1	Immune System
MYF5	Developmental Biology
MYF6	Developmental Biology
MYH3	Membrane Trafficking
MYH4	Membrane Trafficking
MYH1	Membrane Trafficking
MYH2	Immune System
MYH8	Membrane Trafficking
MYH9	Developmental Biology
MYH6	Membrane Trafficking
MYH7	Membrane Trafficking
MYH13	Membrane Trafficking
MYH10	Developmental Biology
MYH11	Developmental Biology
IMPA2	Metabolism
MYOG	Developmental Biology
MYOD1	Developmental Biology
MYBPC3	Muscle contraction
IMPA1	Metabolism
MYBPC2	Muscle contraction
CD200R1	Immune System
MLN	Signal Transduction
SLC16A3	Bile salt and organic anion SLC transporters
SLC16A1	Bile salt and organic anion SLC transporters
SLC16A8	Bile salt and organic anion SLC transporters
SLC16A7	Bile salt and organic anion SLC transporters
MAP2K7	Cellular responses to stress
MAP2K2	Developmental Biology
MAP2K4	Cellular responses to stress
MAP2K5	Signal Transduction
MAP2K1	Developmental Biology
MMP25	Extracellular matrix organization
MMP24	Extracellular matrix organization
MMP20	Extracellular matrix organization
MMP19	Extracellular matrix organization
MMP17	Extracellular matrix organization
MMP16	Extracellular matrix organization
MMP15	Extracellular matrix organization
MMP14	Extracellular matrix organization
MMP13	Extracellular matrix organization
MMP12	Extracellular matrix organization
MMP11	Extracellular matrix organization
MMP10	Extracellular matrix organization
MMP9	Extracellular matrix organization
MMP8	Extracellular matrix organization
MSN	Developmental Biology
CAB39L	Signal Transduction
MOCS3	Disease
CAB39	Signal Transduction
ALDH6A1	Metabolism
MSR1	Binding and Uptake of Ligands by Scavenger Receptors
MSH4	Cell Cycle
MSH5	Cell Cycle
MC1R	Signal Transduction
MTAP	Metabolism
MT2A	Immune System
IGF2R	Membrane Trafficking
M6PR	Membrane Trafficking
MARCO	Binding and Uptake of Ligands by Scavenger Receptors
MRE11A	Cell Cycle
MPP5	Cell-Cell communication
PMPCB	Metabolism of proteins
PMPCA	Metabolism of proteins
MBTPS1	Metabolism
MOCS2	Disease
ABCC6	Transmembrane transport of small molecules
MBTPS2	Metabolism
ABCC1	Disease
ABCC4	Hemostasis
ABCC5	Disease
ABCC2	Transmembrane transport of small molecules
ABCC3	Metabolism
MDK	Signal Transduction
MTNR1B	Signal Transduction
MTNR1A	Signal Transduction
MKRN1	Immune System
MAPKAPK2	Cellular responses to stress
MAPK11	Cell-Cell communication
MAPK10	Cellular responses to stress
MAPK13	Cell-Cell communication
MAPK7	Cellular responses to stress
MAPK8	Apoptosis
MAPK9	Cellular responses to stress
MAPK1	Cell Cycle
MAPK3	Cell Cycle
MIP	Transmembrane transport of small molecules
MMP7	Extracellular matrix organization
MMP3	Extracellular matrix organization
MMP1	Extracellular matrix organization
MLX	Metabolism
MALT1	Immune System
MYL2	Muscle contraction
MYL9	Developmental Biology
MLH3	Cell Cycle
MLH1	Cell Cycle
MYL6B	Muscle contraction
MYL3	Muscle contraction
MYL6	Developmental Biology
MYL4	Muscle contraction
MYL1	Muscle contraction
PMCH	Signal Transduction
CASC3	Gene Expression
MFNG	Signal Transduction
MFGE8	Disease
SLC25A32	Disease
MGAM	Disease
MAT1A	Metabolism
MAT2A	Metabolism
MFAP1	Extracellular matrix organization
MFAP3	Extracellular matrix organization
MFAP2	Extracellular matrix organization
MFAP5	Extracellular matrix organization
MFAP4	Extracellular matrix organization
MERTK	Hemostasis
MTR	Disease
MEF2C	Developmental Biology
MEF2D	Developmental Biology
MEN1	Disease
CXCL3	Signal Transduction
OGN	Disease
GRM5	Signal Transduction
GRM4	Signal Transduction
GRM3	Signal Transduction
GRM2	Signal Transduction
CXCL2	Signal Transduction
GRM8	Signal Transduction
GRM7	Signal Transduction
GRM6	Signal Transduction
MGMT	DNA Repair
GRM1	Signal Transduction
MAGOH	Gene Expression
MAGED1	Apoptosis
AIMP1	Gene Expression
AIMP2	Gene Expression
EEF1E1	Gene Expression
SLC25A20	Metabolism
MC3R	Signal Transduction
MC4R	Signal Transduction
MC5R	Signal Transduction
MCCC1	Disease
MCCC2	Disease
MATK	Signal Transduction
ABCB1	Metabolism
ABCB4	Metabolism
DPEP1	Metabolism
MDH1	Disease
MDH2	Disease
MEF2A	Developmental Biology
MEF2B	Developmental Biology
MED6	Developmental Biology
CMA1	Extracellular matrix organization
CD46	Immune System
LY96	Immune System
GSTZ1	Metabolism
MBL2	Immune System
MARCKS	Metabolism
MAPRE1	Cell Cycle
MAFF	Hemostasis
MAFG	Hemostasis
SLC25A11	Disease
MAP3K1	Immune System
MAP3K3	Immune System
MAP3K5	Cellular responses to stress
MAP3K8	Immune System
MAP3K14	Immune System
LEMD3	Cell Cycle
MPI	Metabolism of proteins
MRC1	Immune System
ME1	Metabolism
MAFK	Hemostasis
MAG	Hemostasis
PAM16	Metabolism of proteins
Ig lambda chain V-II region BUR	Binding and Uptake of Ligands by Scavenger Receptors
Ig lambda chain V-II region MGC	Binding and Uptake of Ligands by Scavenger Receptors
Ig lambda chain V-II region BOH	Binding and Uptake of Ligands by Scavenger Receptors
Ig lambda chain V-II region TRO	Binding and Uptake of Ligands by Scavenger Receptors
Ig lambda chain V-II region TOG	Binding and Uptake of Ligands by Scavenger Receptors
Ig lambda chain V-II region NEI	Binding and Uptake of Ligands by Scavenger Receptors
Ig lambda chain V-I region MEM	Binding and Uptake of Ligands by Scavenger Receptors
Ig lambda chain V-I region EPS	Binding and Uptake of Ligands by Scavenger Receptors
Ig lambda chain V-I region WAH	Binding and Uptake of Ligands by Scavenger Receptors
Ig lambda chain V-I region BL2	Binding and Uptake of Ligands by Scavenger Receptors
Ig lambda chain V-I region NIG-64	Binding and Uptake of Ligands by Scavenger Receptors
Ig lambda chain V-I region NEWM	Binding and Uptake of Ligands by Scavenger Receptors
Ig lambda chain V-I region HA	Binding and Uptake of Ligands by Scavenger Receptors
Ig lambda chain V-I region NEW	Binding and Uptake of Ligands by Scavenger Receptors
Ig lambda chain V region 4A	Binding and Uptake of Ligands by Scavenger Receptors
Ig lambda chain V-I region VOR	Binding and Uptake of Ligands by Scavenger Receptors
Ig lambda chain V-VI region NIG-48	Binding and Uptake of Ligands by Scavenger Receptors
Ig lambda chain V-VI region AR	Binding and Uptake of Ligands by Scavenger Receptors
Ig lambda chain V-V region DEL	Binding and Uptake of Ligands by Scavenger Receptors
Ig lambda chain V-IV region MOL	Binding and Uptake of Ligands by Scavenger Receptors
Ig lambda chain V-IV region Kern	Binding and Uptake of Ligands by Scavenger Receptors
Ig lambda chain V-IV region Hil	Binding and Uptake of Ligands by Scavenger Receptors
Ig lambda chain V-IV region X	Binding and Uptake of Ligands by Scavenger Receptors
Ig lambda chain V-IV region Bau	Binding and Uptake of Ligands by Scavenger Receptors
Ig lambda chain V-III region LOI	Binding and Uptake of Ligands by Scavenger Receptors
Ig lambda chain V-III region SH	Binding and Uptake of Ligands by Scavenger Receptors
Ig lambda chain V-II region NIG-84	Binding and Uptake of Ligands by Scavenger Receptors
Ig lambda chain V-II region NIG-58	Binding and Uptake of Ligands by Scavenger Receptors
Ig lambda chain V-II region WIN	Binding and Uptake of Ligands by Scavenger Receptors
Ig lambda chain V-II region VIL	Binding and Uptake of Ligands by Scavenger Receptors
Ig lambda chain V-II region BO	Binding and Uptake of Ligands by Scavenger Receptors
LYZ	Disease
ALOX15B	Metabolism
Ig lambda chain V-VI region SUT	Binding and Uptake of Ligands by Scavenger Receptors
Ig lambda chain V-VI region WLT	Binding and Uptake of Ligands by Scavenger Receptors
Ig lambda chain V-VI region EB4	Binding and Uptake of Ligands by Scavenger Receptors
Ig lambda chain V-VII region MOT	Binding and Uptake of Ligands by Scavenger Receptors
MAN2A2	Metabolism of proteins
MAN1B1	Metabolism of proteins
MAN1A2	Metabolism of proteins
MAN2A1	Metabolism of proteins
MAN1C1	Metabolism of proteins
MAN1A1	Metabolism of proteins
LOX	Extracellular matrix organization
LYN	Hemostasis
SH2B3	Hemostasis
LAMP2	Hemostasis
LMOD1	Muscle contraction
LAMC1	Developmental Biology
LAMC2	Cell-Cell communication
LAMC3	Extracellular matrix organization
ALOX12B	Metabolism
ALOX12	Metabolism
ALOX5	Metabolism
ALOX15	Metabolism
LPIN2	Cell Cycle
LPIN1	Cell Cycle
LCT	Disease
LOXL2	Extracellular matrix organization
LOXL1	Extracellular matrix organization
LOXL4	Extracellular matrix organization
LOXL3	Extracellular matrix organization
LRP1	Binding and Uptake of Ligands by Scavenger Receptors
LRP2	Disease
LHB	Metabolism of proteins
LHCGR	Signal Transduction
LPIN3	Cell Cycle
CERS1	Metabolism
LTBP1	Extracellular matrix organization
LUM	Disease
SELP	Hemostasis
SELE	Hemostasis
SELL	Hemostasis
LEFTY1	Developmental Biology
LFNG	Signal Transduction
CD58	Hemostasis
SPN	Hemostasis
RXFP2	Signal Transduction
RXFP1	Signal Transduction
LGMN	Immune System
LIMK1	Developmental Biology
LIMK2	Developmental Biology
PNLIP	Disease
LPL	Developmental Biology
PNLIPRP2	Metabolism
PNLIPRP1	Metabolism
LTA4H	Metabolism
LIPE	Metabolism
PAFAH1B1	Cell Cycle
LAMA5	Extracellular matrix organization
LAMB1	Developmental Biology
LAMB2	Extracellular matrix organization
LAMB3	Cell-Cell communication
LAMA1	Developmental Biology
LAMA2	Extracellular matrix organization
LAMA3	Cell-Cell communication
LAMA4	Extracellular matrix organization
Ig kappa chain V region EV15	Binding and Uptake of Ligands by Scavenger Receptors
Ig kappa chain V-IV region B17	Binding and Uptake of Ligands by Scavenger Receptors
Ig kappa chain V-IV region JI	Binding and Uptake of Ligands by Scavenger Receptors
KYNU	Metabolism
KCNAB3	Neuronal System
KCNAB2	Neuronal System
LTB4R2	Signal Transduction
LTB4R	Signal Transduction
LMNA	Apoptosis
LMNB1	Apoptosis
SLC7A5	Amino acid and oligopeptide SLC transporters
SLC7A8	Amino acid and oligopeptide SLC transporters
PTGR1	Metabolism
LAT	Hemostasis
LBP	Immune System
LNPEP	Immune System
LTC4S	Metabolism
LCAT	Metabolism
SPTLC2	Metabolism
SPTLC1	Metabolism
ACSL1	Metabolism
ACSL4	Metabolism
ACSL3	Metabolism
ACSL6	Metabolism
ACSL5	Metabolism
LCK	Disease
LCP2	Hemostasis
LDHA	Metabolism
LDHB	Disease
LDLR	Disease
LGALS3	Immune System
Ig kappa chain V-III region IARC/BL41	Binding and Uptake of Ligands by Scavenger Receptors
Ig kappa chain V-III region VH	Binding and Uptake of Ligands by Scavenger Receptors
Ig kappa chain V-III region VG	Binding and Uptake of Ligands by Scavenger Receptors
Ig kappa chain V-III region CLL	Binding and Uptake of Ligands by Scavenger Receptors
Ig kappa chain V-IV region Len	Binding and Uptake of Ligands by Scavenger Receptors
IGKV4-1	Binding and Uptake of Ligands by Scavenger Receptors
Ig kappa chain V-III region HIC	Binding and Uptake of Ligands by Scavenger Receptors
Ig kappa chain V-III region HAH	Binding and Uptake of Ligands by Scavenger Receptors
Ig kappa chain V-III region NG9	Binding and Uptake of Ligands by Scavenger Receptors
Ig kappa chain V-III region SIE	Binding and Uptake of Ligands by Scavenger Receptors
Ig kappa chain V-III region B6	Binding and Uptake of Ligands by Scavenger Receptors
Ig kappa chain V-II region RPMI 6410	Binding and Uptake of Ligands by Scavenger Receptors
Ig kappa chain V-III region GOL	Binding and Uptake of Ligands by Scavenger Receptors
Ig kappa chain V-III region POM	Binding and Uptake of Ligands by Scavenger Receptors
Ig kappa chain V-III region WOL	Binding and Uptake of Ligands by Scavenger Receptors
Ig kappa chain V-III region Ti	Binding and Uptake of Ligands by Scavenger Receptors
Ig kappa chain V-I region WAT	Binding and Uptake of Ligands by Scavenger Receptors
Ig kappa chain V-II region Cum	Binding and Uptake of Ligands by Scavenger Receptors
Ig kappa chain V-I region Walker	Binding and Uptake of Ligands by Scavenger Receptors
Ig kappa chain V-I region Daudi	Binding and Uptake of Ligands by Scavenger Receptors
Ig kappa chain V-II region TEW	Binding and Uptake of Ligands by Scavenger Receptors
Ig kappa chain V-II region GM607	Binding and Uptake of Ligands by Scavenger Receptors
Ig kappa chain V-II region FR	Binding and Uptake of Ligands by Scavenger Receptors
Ig kappa chain V-II region MIL	Binding and Uptake of Ligands by Scavenger Receptors
Ig kappa chain V-I region Scw	Binding and Uptake of Ligands by Scavenger Receptors
Ig kappa chain V-I region WEA	Binding and Uptake of Ligands by Scavenger Receptors
Ig kappa chain V-I region Rei	Binding and Uptake of Ligands by Scavenger Receptors
Ig kappa chain V-I region Roy	Binding and Uptake of Ligands by Scavenger Receptors
Ig kappa chain V-I region Ni	Binding and Uptake of Ligands by Scavenger Receptors
Ig kappa chain V-I region BAN	Binding and Uptake of Ligands by Scavenger Receptors
Ig kappa chain V-I region Wes	Binding and Uptake of Ligands by Scavenger Receptors
Ig kappa chain V-I region Mev	Binding and Uptake of Ligands by Scavenger Receptors
Ig kappa chain V-I region Hau	Binding and Uptake of Ligands by Scavenger Receptors
Ig kappa chain V-I region Gal	Binding and Uptake of Ligands by Scavenger Receptors
IGKV1-5	Binding and Uptake of Ligands by Scavenger Receptors
Ig kappa chain V-I region HK101	Binding and Uptake of Ligands by Scavenger Receptors
Ig kappa chain V-I region Kue	Binding and Uptake of Ligands by Scavenger Receptors
Ig kappa chain V-I region Ka	Binding and Uptake of Ligands by Scavenger Receptors
Ig kappa chain V-I region OU	Binding and Uptake of Ligands by Scavenger Receptors
Ig kappa chain V-I region Lay	Binding and Uptake of Ligands by Scavenger Receptors
XRCC5	DNA Repair
XRCC6	DNA Repair
Ig kappa chain V-I region AU	Binding and Uptake of Ligands by Scavenger Receptors
Ig kappa chain V-I region AG	Binding and Uptake of Ligands by Scavenger Receptors
Ig kappa chain V-I region CAR	Binding and Uptake of Ligands by Scavenger Receptors
Ig kappa chain V-I region Bi	Binding and Uptake of Ligands by Scavenger Receptors
Ig kappa chain V-I region EU	Binding and Uptake of Ligands by Scavenger Receptors
Ig kappa chain V-I region DEE	Binding and Uptake of Ligands by Scavenger Receptors
SYK	Hemostasis
DTYMK	Metabolism
ZNF160	Gene Expression
BRAF	Disease
AKT1	Apoptosis
RAF1	Developmental Biology
PRPS1L1	Disease
PRPS2	Disease
PRPS1	Disease
PRKCZ	Disease
PRKCQ	Apoptosis
PRKD1	Metabolism
PRKCH	Hemostasis
PRKCG	Disease
PRKCI	Cell-Cell communication
PRKCD	Apoptosis
PRKCE	Disease
PRKCA	Cell Cycle
PRKCB	Cell Cycle
PHKG1	Disease
PHKG2	Disease
PHKA2	Disease
PHKB	Disease
PHKA1	Disease
KNG1	Hemostasis
KCNC1	Neuronal System
KCNC3	Neuronal System
KLK13	Metabolism of proteins
KLK7	Extracellular matrix organization
KLK1	Metabolism of proteins
KLK2	Extracellular matrix organization
KLF5	Developmental Biology
KLF4	Developmental Biology
KIF5A	Hemostasis
MVK	Metabolism
KIF5B	Hemostasis
KISS1	Signal Transduction
ACVR1B	Developmental Biology
TK2	Cell Cycle
KIT	Disease
KLC2	Hemostasis
KLC4	Hemostasis
KLC1	Hemostasis
KHK	Disease
GUK1	Metabolism
KLHL20	Immune System
KIF9	Hemostasis
KIF2A	Cell Cycle
CHKA	Metabolism
CHKB	Metabolism
KIF2C	Cell Cycle
KIF3A	Hemostasis
KIF3B	Hemostasis
KIF3C	Hemostasis
KIF4A	Developmental Biology
KIF5C	Metabolism of proteins
KIFC1	Hemostasis
KIFAP3	Hemostasis
ARHGAP39	Developmental Biology
PRKG2	Hemostasis
SLC39A7	Transmembrane transport of small molecules
GPCPD1	Metabolism
KEAP1	Immune System
KERA	Disease
COL20A1	Extracellular matrix organization
DGKA	Hemostasis
CMPK1	Metabolism
KCNV2	Neuronal System
KCNS1	Neuronal System
KCNS2	Neuronal System
DGKZ	Hemostasis
DGKI	Hemostasis
DGKQ	Hemostasis
DGKE	Hemostasis
DGKG	Hemostasis
DGKB	Hemostasis
DGKD	Hemostasis
KCNH8	Neuronal System
KCNH7	Neuronal System
KCNH6	Neuronal System
KCNH5	Neuronal System
KCNH4	Neuronal System
KCNH3	Neuronal System
KCNH2	Neuronal System
KCNH1	Neuronal System
CKMT1A	Metabolism
CKMT2	Metabolism
CKM	Metabolism
CKB	Metabolism
KCNN4	Neuronal System
KCNN3	Neuronal System
KCNN2	Neuronal System
KCNN1	Neuronal System
KCNB2	Neuronal System
CAMK4	Disease
CAMK2A	Cellular responses to stress
KCNG1	Neuronal System
KCNG3	Neuronal System
KCNG4	Neuronal System
CAMK2B	Cellular responses to stress
CAMK2D	Cellular responses to stress
CAMK2G	Cellular responses to stress
KCNF1	Neuronal System
CSNK1A1	Signal Transduction
CSNK1E	Cell Cycle
CSNK1D	Cell Cycle
NFKB2	Immune System
CSNK1G2	Metabolism
CSNK2B	Cell Cycle
CSNK2A2	Cell Cycle
PFKL	Disease
PFKP	Disease
IGKC	Binding and Uptake of Ligands by Scavenger Receptors
AK1	Metabolism
AK2	Metabolism
RPS6KA1	Cellular responses to stress
RPS6KA2	Cellular responses to stress
RPS6KA3	Cellular responses to stress
RPS6KA6	Developmental Biology
RPS6KB1	Signal Transduction
RPS6KB2	Disease
PFKM	Disease
PRKAR2B	Cell Cycle
PRKAR2A	Disease
PRKACB	Disease
PRKACA	Cell Cycle
PRKACG	Disease
NFKB1	Cellular responses to stress
AK3	Hemostasis
AK5	Metabolism
KLKB1	Extracellular matrix organization
PRKAR1B	Disease
PRKAR1A	Disease
KIR3DL1	Immune System
KIR2DS5	Immune System
KIR2DS4	Immune System
KIR3DS1	Immune System
KIR3DL2	Immune System
KIR2DL2	Immune System
KIR2DL1	Immune System
KIR2DS2	Immune System
KIR2DS1	Immune System
KIR2DL4	Immune System
KIF13A	Metabolism of proteins
NUP160	Cell Cycle
JUNB	Disease
ITM2B	Disease
ITK	Immune System
TCF4	Developmental Biology
ITGB8	Extracellular matrix organization
ITGB5	Extracellular matrix organization
ITGB6	Extracellular matrix organization
ITGB3	Developmental Biology
ITGB4	Cell-Cell communication
JAM2	Extracellular matrix organization
F11R	Cell-Cell communication
JAK3	Immune System
JAK2	Hemostasis
JAK1	Immune System
JAG2	Disease
JAG1	Disease
IVD	Metabolism
INSIG1	Metabolism
ITGA2	Developmental Biology
ITGA1	Developmental Biology
ITGA4	Extracellular matrix organization
ITGA3	Extracellular matrix organization
ITGA5	Developmental Biology
ITGA6	Cell-Cell communication
ITGA7	Extracellular matrix organization
ITGA8	Extracellular matrix organization
ITGA9	Developmental Biology
ITGA2B	Developmental Biology
ITGAD	Extracellular matrix organization
ITGAE	Extracellular matrix organization
ITGA10	Developmental Biology
ITGA11	Extracellular matrix organization
ITGAL	Extracellular matrix organization
ITGAM	Extracellular matrix organization
ITGAV	Developmental Biology
ITGAX	Extracellular matrix organization
ITGB1	Cell-Cell communication
ITGB2	Extracellular matrix organization
IRF3	Immune System
IRF2	Hemostasis
IRF1	Hemostasis
IRF7	Immune System
IRF6	Immune System
IRF5	Immune System
IRF4	Immune System
KCNJ3	Neuronal System
KCNJ2	Neuronal System
KCNJ1	Neuronal System
KCNJ8	Neuronal System
KCNJ6	Neuronal System
KCNJ5	Neuronal System
KCNJ4	Neuronal System
KCNJ11	Metabolism
KCNJ12	Neuronal System
KCNJ9	Neuronal System
KCNJ10	Neuronal System
KCNJ16	Neuronal System
KCNJ15	Neuronal System
IRS1	Disease
IRS2	Disease
IRF9	Immune System
DIO3	Metabolism
IFNAR1	Immune System
INS	Developmental Biology
INSR	Signal Transduction
PDX1	Developmental Biology
ITPR3	Disease
ITPKB	Metabolism
ITPKA	Metabolism
PPP1R1B	Signal Transduction
IRAK1	Immune System
IRAK2	Immune System
RBP3	Disease
PPA1	Gene Expression
IFNA4	Hemostasis
IFNA2	Hemostasis
IFNA1	Hemostasis
IFI35	Immune System
IMPDH2	Metabolism
IMPDH1	Metabolism
TNPO1	Gene Expression
IFNA17	Hemostasis
IFNA16	Hemostasis
IFNA14	Hemostasis
IFNA10	Hemostasis
IFNA8	Hemostasis
IFNA7	Hemostasis
IFNA6	Hemostasis
IFNA5	Hemostasis
IFNG	Immune System
IFI6	Immune System
IFNGR1	Immune System
IFNGR2	Immune System
IFNA21	Hemostasis
IFNB1	Hemostasis
INPP1	Metabolism
INSL5	Signal Transduction
IFI27	Immune System
INSL3	Signal Transduction
SREBF1	Circadian Clock
SRC	Cell-Cell communication
SCARF1	Binding and Uptake of Ligands by Scavenger Receptors
SREBF2	Metabolism
SRP72	Gene Expression
SIRPB1	Cell-Cell communication
MED21	Developmental Biology
ALDH5A1	Neuronal System
SSNA1	Cell Cycle
SRMS	Immune System
SRPRB	Gene Expression
SRPR	Gene Expression
SSRP1	Disease
SSR3	Gene Expression
SSTR4	Signal Transduction
SSTR3	Signal Transduction
SSTR2	Signal Transduction
SSTR1	Signal Transduction
SSR4	Gene Expression
SSR2	Gene Expression
SSTR5	Signal Transduction
STAT5A	Disease
STAT5B	Disease
STAT1	Disease
STAT2	Immune System
LRP12	Disease
STK24	Apoptosis
STXBP3	Hemostasis
STAR	Metabolism
STXBP1	Metabolism
STIM1	Hemostasis
STK11	Metabolism
STK4	Signal Transduction
NR5A1	Gene Expression
STK3	Signal Transduction
STT3A	Metabolism of proteins
STS	Metabolism
STARD8	Signal Transduction
STARD6	Metabolism
STARD5	Metabolism
STARD4	Metabolism
SUCLG1	Metabolism
STX4	Hemostasis
SMURF2	Disease
SULT2A1	Metabolism
SI	Disease
SULT1E1	Metabolism
SUOX	Metabolism
SULT1A1	Metabolism
SULT1A2	Metabolism
SULT1A3	Metabolism
MED22	Developmental Biology
SLC23A2	Disease
SLC23A1	Disease
CCL4	Signal Transduction
CCL5	Signal Transduction
CCL2	Metabolism of proteins
CCL3	Signal Transduction
CCL7	Signal Transduction
CCL17	Signal Transduction
CCL16	Signal Transduction
CCL21	Signal Transduction
CCL22	Signal Transduction
CCL19	Signal Transduction
CCL20	Signal Transduction
CCL25	Signal Transduction
AARS	Gene Expression
CCL3L1	Signal Transduction
CCL28	Signal Transduction
CCL27	Signal Transduction
CARS	Gene Expression
XCL2	Signal Transduction
XCL1	Signal Transduction
VAMP7	Membrane Trafficking
FARSA	Gene Expression
EPRS	Gene Expression
DARS	Gene Expression
CX3CL1	Signal Transduction
IARS	Gene Expression
SYNJ1	Metabolism
SYNJ2	Metabolism
KARS	Gene Expression
FARSB	Gene Expression
GARS	Gene Expression
HARS2	Gene Expression
HARS	Gene Expression
NARS	Gene Expression
LARS2	Gene Expression
MARS	Gene Expression
SYN1	Neuronal System
SYN2	Neuronal System
SYT1	Disease
SYT5	Metabolism
RARS	Gene Expression
QARS	Gene Expression
SARS	Gene Expression
SARS2	Gene Expression
SNCA	Disease
TARS	Gene Expression
CXCL9	Signal Transduction
CXCL5	Signal Transduction
CXCL6	Signal Transduction
WARS	Gene Expression
YARS	Gene Expression
VARS	Gene Expression
WARS2	Gene Expression
MED24	Developmental Biology
CXCL16	Signal Transduction
CXCL13	Signal Transduction
CXCL10	Signal Transduction
CXCL11	Signal Transduction
TNFRSF10B	Apoptosis
GTF2A2	Disease
GTF2A1	Disease
MED13	Developmental Biology
TDO2	Metabolism
MED12	Developmental Biology
SMC1B	Cell Cycle
SMC1A	Cell Cycle
SUMO3	Metabolism of proteins
SUMO2	Metabolism of proteins
SLC5A6	Disease
GHRH	Signal Transduction
FHL2	Metabolism
SLC5A1	Disease
SKI	Disease
SLC5A5	Amino acid and oligopeptide SLC transporters
SLC5A4	Disease
SLC5A3	Disease
SLC5A2	Disease
VPS4B	Disease
SKIV2L	Metabolism of proteins
SNW1	Disease
SKIL	Disease
SMAD4	Developmental Biology
SMAD5	Signal Transduction
SMAD7	Disease
SMAD9	Signal Transduction
DIABLO	Apoptosis
SEMA7A	Developmental Biology
SMAD1	Signal Transduction
SMAD2	Developmental Biology
SMAD3	Developmental Biology
SEMA3E	Developmental Biology
SEMA4A	Developmental Biology
SEMA4D	Developmental Biology
SEMA5A	Developmental Biology
SUMO1	Immune System
SEMA3A	Developmental Biology
SNAP23	Membrane Trafficking
SST	Signal Transduction
SMO	Signal Transduction
SMC3	Cell Cycle
SNX5	Membrane Trafficking
SNX2	Membrane Trafficking
SNX3	Signal Transduction
SNAPC3	Gene Expression
SNAPC2	Gene Expression
SNAPC5	Gene Expression
AANAT	Metabolism
SNAPC1	Gene Expression
NAPA	Membrane Trafficking
SOCS3	Immune System
SOCS2	Immune System
SOCS1	Immune System
SOCS6	Signal Transduction
GH2	Immune System
SOD1	Cellular responses to stress
SNX9	Membrane Trafficking
SP100	Immune System
SPCS1	Gene Expression
SP1	Cellular responses to stress
SPCS2	Gene Expression
GH1	Immune System
SORT1	Membrane Trafficking
SOS1	Developmental Biology
SOS2	Developmental Biology
SPTAN1	Apoptosis
SPTB	Developmental Biology
SPTA1	Developmental Biology
SEC11A	Gene Expression
SEC11C	Gene Expression
SPHK1	Metabolism
SRM	Metabolism
AGMAT	Metabolism
SPTBN5	Developmental Biology
SPTBN4	Developmental Biology
SPTBN2	Developmental Biology
SPTBN1	Cell-Cell communication
SUPT4H1	Disease
SERPINB8	Hemostasis
SIPA1	Immune System
NCKIPSD	Immune System
SPRY1	Disease
SPRY2	Disease
SMS	Metabolism
SRP14	Gene Expression
SRP54	Gene Expression
SRP19	Gene Expression
AGXT	Metabolism
SRP9	Gene Expression
SQRDL	Metabolism
SPHK2	Metabolism
SGSH	Disease
SPARC	Binding and Uptake of Ligands by Scavenger Receptors
SPR	Metabolism
SPO11	Cell Cycle
SLC6A13	Amine compound SLC transporters
SLC6A12	Amine compound SLC transporters
SLC6A11	Amine compound SLC transporters
SLC6A9	Amine compound SLC transporters
SLC6A8	Metabolism
SLC6A7	Amine compound SLC transporters
SLC6A6	Amine compound SLC transporters
SLC6A5	Amine compound SLC transporters
SLC6A3	Amine compound SLC transporters
SLC6A2	Amine compound SLC transporters
SLC6A1	Amine compound SLC transporters
AHCY	Metabolism
STAG2	Cell Cycle
STAG3	Cell Cycle
STAG1	Cell Cycle
SLC28A2	Transmembrane transport of small molecules
SLC28A1	Transmembrane transport of small molecules
SEC24D	Immune System
SEC24C	Immune System
SLC26A6	Transmembrane transport of small molecules
SLC26A1	Disease
SEC23A	Immune System
SEC24B	Immune System
SEC24A	Immune System
SLCO4A1	Transmembrane transport of small molecules
SLCO1C1	Transmembrane transport of small molecules
SEC61B	Gene Expression
SRD5A1	Metabolism
SRD5A2	Metabolism
SULT4A1	Metabolism
OXCT1	Metabolism
SHC2	Signal Transduction
SCTR	Signal Transduction
SYCP2	Cell Cycle
SYCP1	Cell Cycle
SUCLG2	Metabolism
SUCLA2	Metabolism
SCAP	Metabolism
EXOC2	Membrane Trafficking
SDC1	Disease
SDC2	Disease
SDCBP	Developmental Biology
SDC3	Disease
SDC4	Disease
SATB1	Apoptosis
SLC1A4	Amino acid and oligopeptide SLC transporters
TRAPPC4	Extracellular matrix organization
GM2A	Metabolism
APCS	Disease
PSAP	Hemostasis
RXFP3	Signal Transduction
SAR1B	Immune System
SCNN1A	Transmembrane transport of small molecules
SCNN1B	Transmembrane transport of small molecules
SCNN1D	Transmembrane transport of small molecules
SCNN1G	Transmembrane transport of small molecules
EXOC5	Membrane Trafficking
SEC13	Cell Cycle
SLC3A1	Amino acid and oligopeptide SLC transporters
SC5D	Metabolism
PHGDH	Metabolism
PSPH	Metabolism
SELPLG	Hemostasis
SET	Cell Cycle
PSAT1	Metabolism
SRSF11	Gene Expression
SRSF7	Gene Expression
EXOC4	Membrane Trafficking
SCT	Signal Transduction
PTTG1	Cell Cycle
SEMG1	Disease
SENP2	Metabolism of proteins
SENP1	Metabolism of proteins
SENP5	Metabolism of proteins
ST3GAL4	Disease
ST3GAL1	Disease
ST3GAL2	Disease
ST6GALNAC2	Metabolism of proteins
ST6GALNAC4	Metabolism of proteins
ST8SIA4	Developmental Biology
ST8SIA2	Developmental Biology
ST8SIA3	Metabolism of proteins
IBSP	Extracellular matrix organization
ST6GAL1	Metabolism of proteins
ST3GAL3	Disease
SCG3	Hemostasis
SGK1	Transmembrane transport of small molecules
SGK2	Transmembrane transport of small molecules
SGK3	Transmembrane transport of small molecules
SH3GL2	Developmental Biology
SHC1	Disease
NR0B2	Gene Expression
RARB	Gene Expression
RARG	Gene Expression
RARA	Gene Expression
RRAS	Developmental Biology
RPIA	Disease
POLRMT	Gene Expression
POLR3K	Gene Expression
POLR3F	Gene Expression
POLR2K	DNA Repair
POLR2J	DNA Repair
POLR3A	Gene Expression
POLR2L	DNA Repair
POLR2H	DNA Repair
POLR2I	DNA Repair
POLR2G	DNA Repair
POLR2F	DNA Repair
POLR2E	DNA Repair
POLR2D	DNA Repair
POLR2C	DNA Repair
POLR2B	DNA Repair
POLR2A	DNA Repair
POLR1D	Gene Expression
POLR1C	Gene Expression
POLR1B	Gene Expression
POLR1A	Gene Expression
RTN4	Signal Transduction
RUVBL2	Chromatin organization
RUNX2	Gene Expression
RUVBL1	Cell Cycle
RHOQ	Signal Transduction
RSU1	Cell-Cell communication
RASA1	Signal Transduction
EXOC6	Membrane Trafficking
SLCO2A1	Transmembrane transport of small molecules
SULT1C4	Metabolism
SLCO1B1	Metabolism
SLCO1A2	Metabolism
SLCO2B1	Transmembrane transport of small molecules
SLCO1B3	Metabolism
SLC12A1	Transmembrane transport of small molecules
SLC12A2	Transmembrane transport of small molecules
SLC12A3	Transmembrane transport of small molecules
SLC12A4	Transmembrane transport of small molecules
SLC12A5	Transmembrane transport of small molecules
SLC12A6	Transmembrane transport of small molecules
SLC12A7	Transmembrane transport of small molecules
SLC13A1	Bile salt and organic anion SLC transporters
SLC13A2	Bile salt and organic anion SLC transporters
SLC13A3	Bile salt and organic anion SLC transporters
SLC13A4	Bile salt and organic anion SLC transporters
S100B	Immune System
S100A12	Immune System
RXRG	Gene Expression
RXRA	Developmental Biology
RYR3	Transmembrane transport of small molecules
RYR1	Transmembrane transport of small molecules
RYR2	Transmembrane transport of small molecules
RPN1	Gene Expression
RIPK1	Apoptosis
RPN2	Gene Expression
RHOH	Signal Transduction
RRM1	Metabolism
RIPK3	Immune System
RIPK2	Immune System
RRM2	Cell Cycle
GRK1	Disease
RFNG	Signal Transduction
RGL1	Metabolism
RAP1GAP	Immune System
RANGAP1	Cell Cycle
RGR	Signal Transduction
RGS9	Disease
RHAG	Amine compound SLC transporters
ARHGAP1	Signal Transduction
RHEB	Signal Transduction
DLC1	Signal Transduction
RND1	Developmental Biology
RHOA	Developmental Biology
RHOB	Developmental Biology
RHOC	Developmental Biology
RHOD	Signal Transduction
RHOF	Signal Transduction
RHOG	Developmental Biology
RING1	Cellular responses to stress
HLA-DMA	Immune System
HLA-DMB	Immune System
RNF4	Immune System
RNF6	Immune System
RNASEL	Immune System
RNF25	Immune System
TRIM21	Immune System
UPF1	Gene Expression
RORC	Gene Expression
RORB	Gene Expression
RORA	Circadian Clock
RAMP2	Signal Transduction
RAMP1	Signal Transduction
RAMP3	Signal Transduction
RAD51	Cell Cycle
RAE1	Cell Cycle
RAC1	Cell-Cell communication
RAB8A	Cell Cycle
RAD52	DNA Repair
RAB7A	Immune System
RAP1B	Hemostasis
HRAS	Developmental Biology
RAP1A	Hemostasis
RDX	Developmental Biology
RAC3	Signal Transduction
RAC2	Developmental Biology
RALB	Signal Transduction
RALA	Membrane Trafficking
RANBP1	Disease
AGER	Immune System
PFAS	Metabolism
PAICS	Metabolism
PPAT	Metabolism
GART	Metabolism
ADSS	Metabolism
ADSL	Metabolism
ATIC	Metabolism
ALDH4A1	Metabolism
PTPRU	Signal Transduction
PTS	Metabolism
PTPRA	Developmental Biology
PTH2R	Signal Transduction
PTH1R	Signal Transduction
RAB11A	Transmembrane transport of small molecules
RAD23B	DNA Repair
PC	Disease
CAD	Metabolism
DHODH	Metabolism
UMPS	Metabolism
PYY	Signal Transduction
CTPS1	Metabolism
NELFE	Disease
RDH5	Disease
CXCR7	Signal Transduction
RB1	Cell Cycle
RHOBTB2	Signal Transduction
RHOBTB1	Signal Transduction
RANBP2	Cell Cycle
RBM5	Gene Expression
RBL1	Cell Cycle
RBL2	Cell Cycle
RBP4	Disease
RBP2	Disease
RBP1	Disease
CLIP1	Cell Cycle
REL	Immune System
REN	Metabolism of proteins
RLN2	Signal Transduction
RCVRN	Disease
RAB2A	Cell Cycle
RAB14	Membrane Trafficking
RAB1B	Cell Cycle
NRAS	Developmental Biology
KRAS	Developmental Biology
RAB13	Membrane Trafficking
RAB10	Membrane Trafficking
RBBP4	Cell Cycle
RBBP8	Cell Cycle
RBBP7	Cell Cycle
KIF20A	Cell Cycle
RAB5A	Hemostasis
RAB5C	Membrane Trafficking
PROK1	Signal Transduction
PRNP	Developmental Biology
PRKDC	DNA Repair
PROK2	Signal Transduction
PRELP	Disease
PRLR	Immune System
PRL	Disease
PYCR1	Metabolism
PRODH	Metabolism
PFN1	Developmental Biology
PAPSS1	Disease
PRDM4	Signal Transduction
PRDM7	Gene Expression
PRDM9	Cell Cycle
PREB	Membrane Trafficking
PPARD	Gene Expression
PPARA	Circadian Clock
ACP5	Disease
PCK2	Disease
PCK1	Developmental Biology
PITPNB	Metabolism
PITPNA	Developmental Biology
PPEF1	Disease
PPOX	Metabolism
PARP1	Disease
NADK	Disease
PPP1CA	Disease
VDAC1	Metabolism of proteins
PPP1CC	Cell Cycle
PPP1CB	Cell Cycle
PTPN1	Hemostasis
SERPINB6	Hemostasis
PTEN	Disease
ACOT8	Metabolism
PTHLH	Signal Transduction
PTH	Signal Transduction
PTGES	Metabolism
PTGIS	Metabolism
PTPN11	Cell-Cell communication
PTPN6	Cell-Cell communication
PTDSS1	Metabolism
PSPN	Developmental Biology
PTCH2	Signal Transduction
PTCH1	Signal Transduction
NPEPPS	Immune System
PSMC5	Apoptosis
PRLH	Signal Transduction
PSMA8	Apoptosis
PROS1	Hemostasis
CTSA	Immune System
PROZ	Metabolism of proteins
PROC	Hemostasis
PYGL	Disease
PYGM	Disease
PYGB	Disease
PCBD1	Metabolism
PTGIR	Hemostasis
PI4KA	Metabolism
PIP4K2A	Metabolism
PIAS1	Immune System
PLCB1	Metabolism
PAH	Disease
PTGS1	Metabolism
PTGS2	Metabolism
PDGFRB	Disease
PDGFRA	Disease
PTGDS	Metabolism
PGK1	Disease
PGM1	Disease
DCN	Disease
SRGN	Hemostasis
BGN	Disease
PFDN5	Metabolism of proteins
PFDN4	Metabolism of proteins
VBP1	Metabolism of proteins
FNTB	Disease
FNTA	Apoptosis
PFDN6	Metabolism of proteins
ACAN	Disease
HSPG2	Disease
HPGD	Metabolism
HPGDS	Metabolism
VCAN	Disease
NCAN	Developmental Biology
PEX3	Transmembrane transport of small molecules
PTGFR	Signal Transduction
PFDN1	Metabolism of proteins
PFDN2	Metabolism of proteins
SLC15A2	Amino acid and oligopeptide SLC transporters
SLC15A1	Amino acid and oligopeptide SLC transporters
PTGER4	Signal Transduction
PTGER2	Signal Transduction
PTGER3	Signal Transduction
PTGER1	Signal Transduction
PDXK	Disease
PENK	Signal Transduction
PEMT	Metabolism
SLC26A4	Transmembrane transport of small molecules
PECAM1	Extracellular matrix organization
PDK4	Metabolism
PDK3	Metabolism
PDK2	Metabolism
PDK1	Metabolism
P4HB	Cellular responses to stress
PDPK1	Disease
PDP2	Metabolism
PDP1	Metabolism
POU2F1	Gene Expression
PANK3	Disease
PANK2	Disease
PNMT	Metabolism
PANK4	Disease
PNP	Metabolism
PNOC	Signal Transduction
PMVK	Metabolism
PML	Immune System
PMM1	Metabolism of proteins
PMM2	Metabolism of proteins
SLC25A17	Metabolism
PGAM2	Disease
PGAM1	Disease
GPAM	Metabolism
PLXNA3	Developmental Biology
PLOD2	Extracellular matrix organization
PLOD3	Extracellular matrix organization
FXYD1	Transmembrane transport of small molecules
PLOD1	Extracellular matrix organization
PLIN1	Developmental Biology
PF4	Hemostasis
CSH1	Immune System
PLG	Extracellular matrix organization
HAPLN1	Extracellular matrix organization
PLD2	Immune System
PLEK	Hemostasis
AGPAT4	Metabolism
AGPAT3	Metabolism
AGPAT5	Metabolism
AGPAT2	Metabolism
AGPAT1	Metabolism
JUP	Cell-Cell communication
PKP1	Apoptosis
PIK3C2G	Metabolism
PIK3C2B	Metabolism
CDIPT	Metabolism
PLCB3	Metabolism
LIMS1	Cell-Cell communication
PIGU	Metabolism of proteins
PIGS	Metabolism of proteins
PIGO	Metabolism of proteins
PIGH	Metabolism of proteins
PIGL	Metabolism of proteins
PIGC	Metabolism of proteins
PIGF	Metabolism of proteins
PIGA	Metabolism of proteins
PLCG1	Developmental Biology
PLCG2	Hemostasis
PLCD1	Metabolism
PICK1	Neuronal System
PLCB2	Metabolism
PLCB4	Metabolism
NAGS	Metabolism
AURKA	Cell Cycle
AURKB	Cell Cycle
MAPT	Apoptosis
TNKS1BP1	Gene Expression
ZW10	Cell Cycle
TOP2A	Cell Cycle
RCC1	Disease
KIF22	Hemostasis
KNTC1	Cell Cycle
KIF23	Cell Cycle
NUP155	Cell Cycle
CDK11B	Cell Cycle
TXNL4A	Gene Expression
UBE2C	APC-Cdc20 mediated degradation of Nek2A
RAD21	Cell Cycle
CALD1	Muscle contraction
GSK3A	Disease
ESR1	Gene Expression
MNAT1	Cell Cycle
RAN	Disease
DOCK9	Hemostasis
DCTN2	Cell Cycle
RAB1A	Cell Cycle
TERF1	Cell Cycle
ANAPC11	APC-Cdc20 mediated degradation of Nek2A
EIF2AK3	Metabolism of proteins
BUB1B	APC-Cdc20 mediated degradation of Nek2A
BUB1	Cell Cycle
CETN2	Cell Cycle
PIN1	Immune System
PPM1B	Immune System
CENPF	Cell Cycle
CENPE	Cell Cycle
MAPK12	Cell-Cell communication
CDC27	APC-Cdc20 mediated degradation of Nek2A
MAD2L2	DNA Repair
SF3B1	Gene Expression
MYBL2	Cell Cycle
TK1	Metabolism
KIF11	Hemostasis
RAB4A	Membrane Trafficking
APP	Disease
PPBP	Hemostasis
CUL1	Cell Cycle
LBR	Metabolism
CKS1B	Cell Cycle
CCNT1	Disease
PLK1	Cell Cycle
PLEC	Apoptosis
PLD1	Immune System
KMO	Metabolism
ACMSD	Metabolism
MCEE	Metabolism
AASS	Metabolism
AADAT	Metabolism
HIBCH	Metabolism
EIF4H	3' -UTR-mediated translational regulation
EIF4B	3' -UTR-mediated translational regulation
EIF4G1	3' -UTR-mediated translational regulation
EIF4E	3' -UTR-mediated translational regulation
EIF5	Gene Expression
RPL39	3' -UTR-mediated translational regulation
RPL38	3' -UTR-mediated translational regulation
RPL37A	3' -UTR-mediated translational regulation
RPL37	3' -UTR-mediated translational regulation
RPL36A	3' -UTR-mediated translational regulation
RPL41	3' -UTR-mediated translational regulation
UBA52	3' -UTR-mediated translational regulation
RPL4	3' -UTR-mediated translational regulation
RPL32	3' -UTR-mediated translational regulation
RPL31	3' -UTR-mediated translational regulation
RPL30	3' -UTR-mediated translational regulation
RPL3L	3' -UTR-mediated translational regulation
RPL36	3' -UTR-mediated translational regulation
RPL35A	3' -UTR-mediated translational regulation
RPL35	3' -UTR-mediated translational regulation
RPL34	3' -UTR-mediated translational regulation
EIF2S1	3' -UTR-mediated translational regulation
EIF2S2	3' -UTR-mediated translational regulation
RPL7	3' -UTR-mediated translational regulation
RPL7A	3' -UTR-mediated translational regulation
RPL5	3' -UTR-mediated translational regulation
RPL6	3' -UTR-mediated translational regulation
RPL8	3' -UTR-mediated translational regulation
RPL9	3' -UTR-mediated translational regulation
EIF3I	3' -UTR-mediated translational regulation
EIF3J	3' -UTR-mediated translational regulation
EIF3F	3' -UTR-mediated translational regulation
EIF3G	3' -UTR-mediated translational regulation
EIF3H	3' -UTR-mediated translational regulation
EIF3B	3' -UTR-mediated translational regulation
EIF2S3	3' -UTR-mediated translational regulation
EIF2B2	Gene Expression
EIF2B1	Gene Expression
EIF2B5	Gene Expression
EIF2B4	Gene Expression
EIF2B3	Gene Expression
EIF4A1	3' -UTR-mediated translational regulation
EIF4A2	3' -UTR-mediated translational regulation
EIF3A	3' -UTR-mediated translational regulation
EIF3D	3' -UTR-mediated translational regulation
EIF3C	3' -UTR-mediated translational regulation
EIF3E	3' -UTR-mediated translational regulation
EIF3K	3' -UTR-mediated translational regulation
EIF1AX	3' -UTR-mediated translational regulation
RPS14	3' -UTR-mediated translational regulation
RPS15	3' -UTR-mediated translational regulation
RPS12	3' -UTR-mediated translational regulation
RPS13	3' -UTR-mediated translational regulation
RPS10	3' -UTR-mediated translational regulation
RPS11	3' -UTR-mediated translational regulation
RPS20	3' -UTR-mediated translational regulation
RPS21	3' -UTR-mediated translational regulation
RPS15A	3' -UTR-mediated translational regulation
RPS2	3' -UTR-mediated translational regulation
RPS18	3' -UTR-mediated translational regulation
RPS19	3' -UTR-mediated translational regulation
RPS16	3' -UTR-mediated translational regulation
RPS17	3' -UTR-mediated translational regulation
RPS29	3' -UTR-mediated translational regulation
RPS28	3' -UTR-mediated translational regulation
RPS27A	3' -UTR-mediated translational regulation
RPS27	3' -UTR-mediated translational regulation
RPS26	3' -UTR-mediated translational regulation
RPS25	3' -UTR-mediated translational regulation
RPS24	3' -UTR-mediated translational regulation
RPS23	3' -UTR-mediated translational regulation
RPS7	3' -UTR-mediated translational regulation
RPS6	3' -UTR-mediated translational regulation
RPS5	3' -UTR-mediated translational regulation
RPS4Y1	3' -UTR-mediated translational regulation
RPS4X	3' -UTR-mediated translational regulation
RPS3A	3' -UTR-mediated translational regulation
FAU	3' -UTR-mediated translational regulation
RPS3	3' -UTR-mediated translational regulation
RPLP0	3' -UTR-mediated translational regulation
RPLP1	3' -UTR-mediated translational regulation
RPLP2	3' -UTR-mediated translational regulation
RPS8	3' -UTR-mediated translational regulation
RPS9	3' -UTR-mediated translational regulation
RPSA	3' -UTR-mediated translational regulation
RPL13	3' -UTR-mediated translational regulation
RPL13A	3' -UTR-mediated translational regulation
RPL14	3' -UTR-mediated translational regulation
RPL15	3' -UTR-mediated translational regulation
RPL10	3' -UTR-mediated translational regulation
RPL10A	3' -UTR-mediated translational regulation
RPL11	3' -UTR-mediated translational regulation
RPL12	3' -UTR-mediated translational regulation
RPL22	3' -UTR-mediated translational regulation
RPL21	3' -UTR-mediated translational regulation
RPL23A	3' -UTR-mediated translational regulation
RPL23	3' -UTR-mediated translational regulation
RPL18	3' -UTR-mediated translational regulation
RPL17	3' -UTR-mediated translational regulation
RPL19	3' -UTR-mediated translational regulation
RPL18A	3' -UTR-mediated translational regulation
RPL28	3' -UTR-mediated translational regulation
RPL27A	3' -UTR-mediated translational regulation
RPL3	3' -UTR-mediated translational regulation
RPL29	3' -UTR-mediated translational regulation
RPL26	3' -UTR-mediated translational regulation
RPL24	3' -UTR-mediated translational regulation
RPL27	3' -UTR-mediated translational regulation
RPL26L1	3' -UTR-mediated translational regulation
ADAR	Gene Expression
GEMIN4	Gene Expression
LSM3	Gene Expression
SLBP	Gene Expression
PABPC1	3' -UTR-mediated translational regulation
EXOSC4	Gene Expression
EXOSC9	Gene Expression
EXOSC3	Gene Expression
EXOSC5	Gene Expression
DIS3	Gene Expression
EXOSC8	Gene Expression
EXOSC7	Gene Expression
EXOSC2	Gene Expression
HTR2C	Signal Transduction
SMN1	Gene Expression
LSM1	Gene Expression
LSM4	Gene Expression
LSM6	Gene Expression
LSM5	Gene Expression
LSM7	Gene Expression
LSM10	Gene Expression
APOBEC1	Gene Expression
ADARB1	Gene Expression
DDX20	Gene Expression
RBM8A	Gene Expression
C1QBP	Hemostasis
NXF1	Gene Expression
CACNA1H	Developmental Biology
EXOSC1	Gene Expression
RNGTT	Disease
U2AF1	Gene Expression
U2AF2	Gene Expression
CPSF1	Gene Expression
CPSF2	Gene Expression
CPSF3	Gene Expression
PAPOLA	Gene Expression
SF3B2	Gene Expression
SF3B3	Gene Expression
SF3B4	Gene Expression
SF3B5	Gene Expression
HNRNPU	Gene Expression
SNRPB2	Gene Expression
SNRPA1	Gene Expression
SF3A2	Gene Expression
SF3A1	Gene Expression
SF3A3	Gene Expression
RBMX	Gene Expression
HNRNPF	Gene Expression
HNRNPH2	Gene Expression
HNRNPH1	Gene Expression
HNRNPL	Gene Expression
HNRNPK	Gene Expression
HNRNPR	Gene Expression
HNRNPM	Gene Expression
CD2BP2	Gene Expression
CDC40	Gene Expression
DHX38	Gene Expression
SRSF9	Gene Expression
SRSF2	Gene Expression
SRSF3	Gene Expression
SRSF4	Gene Expression
PCF11	Gene Expression
CLP1	Gene Expression
SRSF1	Gene Expression
SRSF5	Gene Expression
SRSF6	Gene Expression
PABPN1	Disease
CSTF2	Gene Expression
CSTF1	Gene Expression
CPSF7	Gene Expression
NUDT21	Gene Expression
PCBP1	Gene Expression
SNRPA	Gene Expression
SNRNP70	Gene Expression
SNRPG	Gene Expression
SNRPF	Gene Expression
SNRPE	Gene Expression
HNRNPD	Gene Expression
HNRNPC	Gene Expression
HNRNPA3	Gene Expression
HNRNPA2B1	Gene Expression
HNRNPA1	Gene Expression
HNRNPA0	Gene Expression
PTBP1	Gene Expression
PCBP2	Gene Expression
SNRNP200	Gene Expression
NHP2L1	Gene Expression
PRPF6	Gene Expression
EFTUD2	Gene Expression
DDX23	Gene Expression
GEMIN2	Gene Expression
SNRPD2	Gene Expression
SNRPD3	Gene Expression
SNRPD1	Gene Expression
LSM2	Gene Expression
SNRPB	Gene Expression
PRPF4	Gene Expression
TAF1C	Gene Expression
TAF1A	Gene Expression
RRN3	Gene Expression
TLR2	Immune System
TLR6	Immune System
TLR5	Immune System
TLR4	Immune System
TLR3	Immune System
TLE2	Disease
TLE1	Disease
TKT	Disease
TLN1	Developmental Biology
TOLLIP	Immune System
TLE4	Disease
ZFP36L1	Gene Expression
TAC3	Signal Transduction
TAC1	Signal Transduction
TIMP1	Extracellular matrix organization
TIMP2	Extracellular matrix organization
TINF2	Cell Cycle
TIRAP	Immune System
TMOD1	Muscle contraction
TMLHE	Metabolism
PMEPA1	Disease
TRIM11	Immune System
TLR8	Immune System
TLR10	Immune System
TNIK	Cellular responses to stress
TNF	Apoptosis
FASLG	Apoptosis
CD40LG	Immune System
TNFSF13	Gene Expression
TNFSF10	Apoptosis
TPM2	Muscle contraction
TPM1	Muscle contraction
TPM4	Muscle contraction
TPM3	Muscle contraction
TNNC2	Muscle contraction
TNNC1	Muscle contraction
PLAT	Hemostasis
TOP3A	Cell Cycle
FAS	Apoptosis
TNFAIP3	Immune System
NGFR	Signal Transduction
TNFRSF21	Metabolism
TNFRSF1A	Apoptosis
NR2C1	Gene Expression
NR2C2	Gene Expression
THPO	Hemostasis
MPL	Hemostasis
TPMT	Metabolism
TPR	Cell Cycle
TPP2	Immune System
TPP1	Metabolism of proteins
TPTE	Metabolism
TAPBP	Immune System
TNFRSF14	Immune System
LTF	Disease
TRHR	Signal Transduction
JMJD1C	Hemostasis
TRIP12	Immune System
TNNI3	Muscle contraction
TNNI2	Muscle contraction
TNNI1	Muscle contraction
NTRK1	Signal Transduction
TRAF2	Apoptosis
TRAF3	Immune System
TRADD	Apoptosis
TPSAB1	Extracellular matrix organization
TRAM1	Gene Expression
THBD	Hemostasis
TRDN	Transmembrane transport of small molecules
TARBP2	Gene Expression
TREH	Disease
TF	Hemostasis
TERF2	Cell Cycle
TNNT2	Muscle contraction
TNNT3	Muscle contraction
TNNT1	Muscle contraction
TRPC6	Developmental Biology
TRPC7	Developmental Biology
PRSS2	Extracellular matrix organization
PRSS3	Disease
TXNRD1	Cellular responses to stress
PRSS1	Disease
TRPM2	Transmembrane transport of small molecules
TRPC5	Developmental Biology
TRPC4	Developmental Biology
TRPC3	Developmental Biology
TRPC1	Developmental Biology
ZFP36	Gene Expression
TTR	Disease
TSHB	Metabolism of proteins
TSHR	Signal Transduction
TSC1	Signal Transduction
THBS3	Signal Transduction
THBS2	Metabolism of proteins
THBS4	Signal Transduction
THBS1	Extracellular matrix organization
TAF10	Chromatin organization
TAF11	Disease
TAF12	Chromatin organization
TAF4B	Disease
GTF2E1	Disease
GTF2E2	Disease
GTF2F1	Disease
TAF1	Disease
TAF5	Disease
TAF6	Disease
TCF7L2	Signal Transduction
TRPC4AP	Transmembrane transport of small molecules
GTF2F2	Disease
CD96	Immune System
TALDO1	Disease
TAB1	Immune System
TBXA2R	Hemostasis
TAP1	Immune System
TANK	Immune System
TAP2	Immune System
TUBB4A	Cell Cycle
TUBB3	Cell Cycle
TUBA1C	Cell Cycle
TBL1X	Disease
TUBG2	Cell Cycle
TBL1XR1	Disease
TBCC	Metabolism of proteins
TUBG1	Cell Cycle
TBC1D4	Membrane Trafficking
TBCB	Metabolism of proteins
TBCA	Metabolism of proteins
TCEA1	DNA Repair
TRBC1	Immune System
ZNF354A	Gene Expression
TRAC	Immune System
TBX5	Gene Expression
CCT6A	Metabolism of proteins
CCT8	Metabolism of proteins
CCT7	Metabolism of proteins
CCT3	Metabolism of proteins
CCT5	Metabolism of proteins
CCT4	Metabolism of proteins
CCT2	Metabolism of proteins
TCP1	Metabolism of proteins
TCN2	Disease
TCN1	Disease
TPD52	Membrane Trafficking
TPD52L1	Membrane Trafficking
TDG	DNA Repair
TERF2IP	Cell Cycle
TEAD1	Gene Expression
TEAD2	Gene Expression
TEAD3	Gene Expression
TEAD4	Gene Expression
PTGES3	Cellular responses to stress
TEC	Immune System
TCAP	Muscle contraction
TERT	Cell Cycle
TNXB	Extracellular matrix organization
TNC	Extracellular matrix organization
TESK1	Cell-Cell communication
TRIM24	Disease
TRIM33	Disease
TRIM28	Gene Expression
GTF3A	Gene Expression
BRF1	Gene Expression
GTF2B	Disease
TBP	Disease
RELA	Cellular responses to stress
TFAM	Gene Expression
GTF2H3	DNA Repair
GTF2H4	DNA Repair
GTF2H1	DNA Repair
GTF2H2	DNA Repair
TAZ	Metabolism
F3	Hemostasis
TFPI	Hemostasis
TFRC	Membrane Trafficking
LEFTY2	Developmental Biology
TGIF1	Disease
TGIF2	Disease
TGFB2	Extracellular matrix organization
TGFB1	Disease
TGFB3	Extracellular matrix organization
TGOLN2	Membrane Trafficking
TBXAS1	Metabolism
TGFBR1	Disease
TGFBR2	Disease
ACAT1	Metabolism
ACAA1	Metabolism
TST	Metabolism
SLC19A2	Disease
F2	Hemostasis
TXN	Cellular responses to stress
TRH	Signal Transduction
TEK	Hemostasis
VIP	Signal Transduction
VIPR2	Signal Transduction
VCL	Hemostasis
VIM	Apoptosis
VIPR1	Signal Transduction
SORBS3	Muscle contraction
VHL	Cellular responses to stress
FLT4	Signal Transduction
KDR	Extracellular matrix organization
VEGFC	Hemostasis
FIGF	Hemostasis
USO1	Cell Cycle
VDR	Gene Expression
VCAM1	Extracellular matrix organization
VAV1	Disease
VAV2	Developmental Biology
ATP6V0B	Disease
ATP6AP2	Metabolism of proteins
ATP6V0C	Disease
ATP6V1H	Disease
ATP6V1F	Disease
ATP6V1E1	Disease
ATP6V1D	Disease
ATP6V1C1	Disease
VASP	Cell-Cell communication
VAPB	Metabolism
VAPA	Metabolism
VAMP2	Disease
ATP6V1G2	Disease
ATP6V1G3	Disease
CUL5	Disease
ATP6V1G1	Disease
ATP6V1B1	Disease
ATP6V1B2	Disease
ATP6V1A	Disease
ATP6V0E1	Disease
WDR1	Hemostasis
WAS	Immune System
WASL	Cell-Cell communication
WIPF1	Immune System
WASF1	Immune System
WASF2	Immune System
WASF3	Immune System
GC	Metabolism
VTN	Extracellular matrix organization
VWF	Extracellular matrix organization
TCIRG1	Disease
ATP6V0A2	Disease
ATP6V0A1	Disease
VPS45	Hemostasis
VPS35	Signal Transduction
VPS29	Signal Transduction
VPS28	Disease
SLC18A2	Amine compound SLC transporters
VPS26A	Signal Transduction
BEST1	Transmembrane transport of small molecules
SLC18A1	Amine compound SLC transporters
GGCX	Metabolism of proteins
SLC27A2	Metabolism
XPA	DNA Repair
ERCC5	DNA Repair
ERCC3	DNA Repair
XPC	DNA Repair
ERCC2	DNA Repair
ERCC4	DNA Repair
WSB1	Immune System
DCTN6	Immune System
XDH	Metabolism
SLC7A11	Amino acid and oligopeptide SLC transporters
XAB2	DNA Repair
WNT8A	Signal Transduction
WNT8B	Signal Transduction
WNT7A	Signal Transduction
WNT7B	Signal Transduction
WNT5A	Signal Transduction
WNT5B	Signal Transduction
WNT2B	Signal Transduction
WNT3A	Signal Transduction
MLXIPL	Metabolism
WNT6	Signal Transduction
WNT3	Signal Transduction
WNT4	Signal Transduction
WNT1	Signal Transduction
WNT2	Signal Transduction
WFS1	Metabolism of proteins
WNT10B	Signal Transduction
WNT10A	Signal Transduction
WNT16	Signal Transduction
WNT9B	Signal Transduction
WNT9A	Signal Transduction
WNT11	Signal Transduction
SMG7	Gene Expression
FIG4	Metabolism
GINS1	Cell Cycle
LPGAT1	Metabolism
TATDN2	Metabolism of proteins
EDEM1	Metabolism of proteins
MLEC	Metabolism of proteins
XRCC1	DNA Repair
CUL7	Immune System
PHF5A	Gene Expression
TYMS	Cell Cycle
TYMP	Metabolism
TYK2	Immune System
TYROBP	Cell-Cell communication
RBCK1	Immune System
TEX12	Cell Cycle
TCRB	Immune System
T-cell receptor alpha chain V region HPB-MLT	Immune System
TCRA	Immune System
T-cell receptor alpha chain V region PY14	Immune System
TRBV12-3	Immune System
TMSB4X	Hemostasis
SLC25A1	Disease
TXK	Immune System
UBE2G2	Immune System
UBE2N	Immune System
UBE2M	Disease
UBE2H	Immune System
UBE2G1	Immune System
UBE2I	Cell Cycle
UBTF	Gene Expression
UBE2D1	APC-Cdc20 mediated degradation of Nek2A
UBE2D2	Cellular responses to stress
UBE2D3	Cellular responses to stress
UBA1	Immune System
UBOX5	Immune System
SUN1	Cell Cycle
SUN2	Cell Cycle
UAP1	Metabolism of proteins
UBE4A	Immune System
UBE2E1	APC-Cdc20 mediated degradation of Nek2A
CDC34	Immune System
UBE2L3	Immune System
UBE2A	Immune System
UBE2L6	Immune System
UBE2S	Immune System
UBE2K	Immune System
UBA7	Immune System
UBE2B	Immune System
UQCRB	Metabolism
UQCRC2	Metabolism
UQCRC1	Metabolism
UCP2	Metabolism
UCP1	Metabolism
UGT1A1	Metabolism
UQCR11	Metabolism
UQCR10	Metabolism
UQCRQ	Metabolism
ISG15	Immune System
UQCRFS1	Metabolism
UQCRH	Metabolism
UGT2B10	Metabolism
UGT2B11	Metabolism
UGT2B4	Metabolism
UGT2B7	Metabolism
UGT1A5	Metabolism
UGT1A6	Metabolism
UGT1A3	Metabolism
UGT1A4	Metabolism
UBE3A	Immune System
UPP1	Metabolism
UGT2B15	Metabolism
UGT2B17	Metabolism
UCHL5	Disease
USP1	DNA Repair
USP15	Disease
USP8	Signal Transduction
USP11	Metabolism of proteins
USP18	Immune System
UCK2	Metabolism
UCK1	Metabolism
PLAUR	Hemostasis
UTS2	Signal Transduction
UTS2R	Signal Transduction
PLAU	Hemostasis
SLC14A1	Amine compound SLC transporters
SLC14A2	Amine compound SLC transporters
AVPR2	Signal Transduction
ATP6V0D1	Disease
AVPR1A	Signal Transduction
AVPR1B	Signal Transduction
SLC35A2	Transmembrane transport of small molecules
UGGT2	Metabolism of proteins
UGDH	Metabolism
SCGB3A2	Binding and Uptake of Ligands by Scavenger Receptors
SLC35A3	Transmembrane transport of small molecules
SLC35D1	Metabolism
CCNO	DNA Repair
STRAP	Disease
ZNF79	Gene Expression
ZNF77	Gene Expression
SLC30A3	Transmembrane transport of small molecules
SLC30A1	Transmembrane transport of small molecules
ZNF92	Gene Expression
ZNF45	Gene Expression
ZNF43	Gene Expression
ZNF3	Gene Expression
ZNF41	Gene Expression
ZKSCAN1	Gene Expression
ZNF75D	Gene Expression
ZNF74	Gene Expression
ZNF70	Gene Expression
ZNF71	Gene Expression
CDK4	Cell Cycle
CDK6	Cell Cycle
CCND3	Cell Cycle
CCND1	Cell Cycle
CCND2	Cell Cycle
TJP2	Apoptosis
ZP2	Reproduction
ZP3	Reproduction
ZWINT	Cell Cycle
ZNF250	Gene Expression
ZFP37	Gene Expression
ZKSCAN5	Gene Expression
ZNF235	Gene Expression
ZAP70	Immune System
ZBP1	Immune System
ZNF18	Gene Expression
ZNF17	Gene Expression
ZNF20	Gene Expression
ZNF19	Gene Expression
ZNF23	Gene Expression
ZNF26	Gene Expression
ZNF25	Gene Expression
ZNF28	Gene Expression
ZNF30	Gene Expression
ZIM2	Gene Expression
ZIM3	Gene Expression
ZNF711	Gene Expression
ZNF10	Gene Expression
ZNF12	Gene Expression
ZNF14	Gene Expression
ZNF708	Gene Expression
CDC6	Cell Cycle
CDT1	Cell Cycle
DBF4	Cell Cycle
ZNF490	Gene Expression
ZNF624	Gene Expression
KLHL9	Immune System
KLHL13	Immune System
ZFP14	Gene Expression
ZNF492	Gene Expression
YES1	Hemostasis
SLC7A7	Amino acid and oligopeptide SLC transporters
ZNF436	Gene Expression
ZNF418	Gene Expression
ZNF124	Gene Expression
ZNF33B	Gene Expression
CEP290	Cell Cycle
CCP110	Cell Cycle
PLCH2	Metabolism
KLHL21	Immune System
ZNF432	Gene Expression
ZFP30	Gene Expression
ZNF510	Gene Expression
YAP1	Gene Expression
DOLK	Metabolism of proteins
YBX1	Gene Expression
ZNF273	Gene Expression
ZNF460	Gene Expression
ZNF274	Gene Expression
ZNF267	Gene Expression
ZNF266	Gene Expression
ZNF268	Gene Expression
ZNF263	Gene Expression
ZNF264	Gene Expression
ZNF254	Gene Expression
ZNF257	Gene Expression
ZNF256	Gene Expression
ZNF300	Gene Expression
ZNF302	Gene Expression
ZNF304	Gene Expression
ZNF287	Gene Expression
ZNF282	Gene Expression
ZNF286A	Gene Expression
ZNF337	Gene Expression
ZNF334	Gene Expression
ZNF333	Gene Expression
ZNF606	Gene Expression
ZNF324	Gene Expression
ZNF317	Gene Expression
ZKSCAN4	Gene Expression
ZKSCAN3	Gene Expression
ZNF398	Gene Expression
ZNF37A	Gene Expression
ZNF382	Gene Expression
RCHY1	Immune System
ZNF347	Gene Expression
ZNF33A	Gene Expression
ZNF143	Gene Expression
TRIM25	Immune System
ZBTB16	Immune System
ZBTB17	Metabolism of proteins
ZNF155	Gene Expression
ZNF154	Gene Expression
ZNF133	Gene Expression
ZNF136	Gene Expression
ZNF135	Gene Expression
ZNF138	Gene Expression
ZNF141	Gene Expression
ZNF140	Gene Expression
ZNF180	Gene Expression
ZNF184	Gene Expression
ZNF189	Gene Expression
ZKSCAN8	Gene Expression
ZNF157	Gene Expression
ZNF169	Gene Expression
ZNF175	Gene Expression
ZNF213	Gene Expression
ZNF212	Gene Expression
ZNF211	Gene Expression
ZNF208	Gene Expression
ZNF215	Gene Expression
ZNF214	Gene Expression
ZMYM2	Disease
ZNF197	Gene Expression
ZNF195	Gene Expression
ZNF205	Gene Expression
ZNF202	Gene Expression
ZNF200	Gene Expression
ZNF234	Gene Expression
ZNF230	Gene Expression
ZNF253	Gene Expression
ZNF222	Gene Expression
ZNF223	Gene Expression
ZNF221	Gene Expression
ZNF226	Gene Expression
ZNF112	Gene Expression
ZNF224	Gene Expression
ZNF225	Gene Expression
TP53	Apoptosis
CDK8	Developmental Biology
CDK9	Disease
CDK5	Developmental Biology
PSMD14	Apoptosis
E2F5	Cell Cycle
E2F4	Cell Cycle
HMGCL	Metabolism
PKMYT1	Cell Cycle
LRAT	Disease
TTF1	Gene Expression
RAD50	Cell Cycle
NBN	Cell Cycle
RDH8	Disease
XRCC4	DNA Repair
PPAP2C	Metabolism
PPAP2A	Metabolism
PPAP2B	Metabolism
RNMT	Disease
NCAPH	Cell Cycle
NCAPG	Cell Cycle
NCAPD2	Cell Cycle
BLOC1S4	Membrane Trafficking
CLDN22	Cell-Cell communication
SCN8A	Developmental Biology
CHEK1	Cell Cycle
CCNE2	Cell Cycle
CCNE1	Cell Cycle
CCNA1	Cdc20:Phospho-APC/C mediated degradation of Cyclin A
CCNB2	Cell Cycle
CCNB1	Cell Cycle
CCNA2	Cdc20:Phospho-APC/C mediated degradation of Cyclin A
GGCT	Metabolism
VTA1	Disease
CEP250	Cell Cycle
CERK	Metabolism
FAM13B	Signal Transduction
CDKN1A	Cell Cycle
CDKN2C	Cell Cycle
CDKN2D	Cell Cycle
CDKN2B	Cell Cycle
CD81	Immune System
CDK1	Cdc20:Phospho-APC/C mediated degradation of Cyclin A
CDK2	Cell Cycle
CDKN2A	Cell Cycle
CDK11A	Cell Cycle
CDK7	Cell Cycle
CDC45	Cell Cycle
CDC16	APC-Cdc20 mediated degradation of Nek2A
CDC23	APC-Cdc20 mediated degradation of Nek2A
CDC20	APC-Cdc20 mediated degradation of Nek2A
CA13	Metabolism
CDH24	Cell-Cell communication
CDK5RAP2	Cell Cycle
CD2AP	Cell-Cell communication
S1PR2	Signal Transduction
ELMO2	Immune System
TCEB1	Cellular responses to stress
TCEB2	Cellular responses to stress
COL26A1	Extracellular matrix organization
EGLN1	Cellular responses to stress
EGLN2	Cellular responses to stress
EGLN3	Cellular responses to stress
TCEB3	Disease
DTX2	Disease
DTX1	Disease
POLE	Cell Cycle
POLD1	Cell Cycle
POLA1	Cell Cycle
E2F1	Apoptosis
E2F3	Cell Cycle
E2F2	Cell Cycle
DNA2	Cell Cycle
POLA2	Cell Cycle
POLD2	Cell Cycle
POLD3	Cell Cycle
POLD4	Cell Cycle
POLE2	Cell Cycle
DOCK8	Hemostasis
DOCK7	Hemostasis
DOCK6	Hemostasis
DOCK5	Hemostasis
DOCK4	Hemostasis
DOCK10	Hemostasis
DOCK2	Disease
DOCK3	Hemostasis
DOCK1	Developmental Biology
DEFA3	Immune System
DEFA1	Immune System
CCNH	Cell Cycle
DEFB105A	Immune System
DEFB131	Immune System
DEFB124	Immune System
DEFB107A	Immune System
DAPK2	Apoptosis
DAPK3	Apoptosis
DTNBP1	Membrane Trafficking
NSL1	Cell Cycle
CRLS1	Metabolism
CPSF4	Disease
POLR3B	Gene Expression
GTF3C1	Gene Expression
POLR3H	Gene Expression
POLR3E	Gene Expression
GTF3C2	Gene Expression
GTF3C5	Gene Expression
GTF3C3	Gene Expression
GTF3C4	Gene Expression
SLC28A3	Transmembrane transport of small molecules
BRF2	Gene Expression
ATM	Cell Cycle
SLC4A9	Transmembrane transport of small molecules
AUH	Metabolism
DEFB1	Immune System
BCMO1	Disease
DTX3L	Immune System
APH1B	A third proteolytic cleavage releases NICD
ANAPC10	APC-Cdc20 mediated degradation of Nek2A
SH2B2	Hemostasis
ARPC4	Immune System
ARHGEF1	Signal Transduction
ADAMTS16	Extracellular matrix organization
PNPLA3	Metabolism
MAGI2	Cell-Cell communication
AMN	Disease
ANAPC5	APC-Cdc20 mediated degradation of Nek2A
ANAPC7	APC-Cdc20 mediated degradation of Nek2A
ANAPC2	APC-Cdc20 mediated degradation of Nek2A
ANAPC4	APC-Cdc20 mediated degradation of Nek2A
ANAPC1	APC-Cdc20 mediated degradation of Nek2A
RPE65	Disease
HLA-DRB3	Immune System
EIF4EBP1	Gene Expression
ATP11C	Transmembrane transport of small molecules
ATP8B4	Transmembrane transport of small molecules
AP3S1	Membrane Trafficking
ACSS1	Metabolism
METTL3	Gene Expression
CDC25C	Cell Cycle
CDC25A	Cell Cycle
CDC25B	Cell Cycle
MKNK1	Disease
MMAB	Disease
MMAA	Disease
NEK6	Cell Cycle
NEK7	Cell Cycle
NEK9	Cell Cycle
NDUFB11	Metabolism
NFASC	Developmental Biology
NUP133	Cell Cycle
MYO18A	Disease
LSM11	Gene Expression
LRR1	Immune System
LILRB4	Immune System
LILRB5	Immune System
LILRB1	Immune System
LILRB2	Immune System
LILRB3	Immune System
WDR77	Gene Expression
MDM2	Cell Cycle
MCM2	Cell Cycle
MCHR2	Signal Transduction
MCM7	Cell Cycle
MCM6	Cell Cycle
MCM5	Cell Cycle
MCM4	Cell Cycle
MCM3	Cell Cycle
MAP4K4	Cellular responses to stress
MINK1	Cellular responses to stress
OR56A3	Signal Transduction
OR56B2P	Signal Transduction
OR56B4	Signal Transduction
OR52P1P	Signal Transduction
OR52R1	Signal Transduction
OR56A1	Signal Transduction
OR56A4	Signal Transduction
INPP5J	Metabolism
PI4KB	Metabolism
PARD3	Cell-Cell communication
PARD6A	Cell-Cell communication
PARD6B	Cell-Cell communication
PARD6G	Cell-Cell communication
ORC1	Cell Cycle
ORC2	Cell Cycle
ORC5	Cell Cycle
ORC3	Cell Cycle
ORC4	Cell Cycle
ORC6	Cell Cycle
OR51L1	Signal Transduction
OR51Q1	Signal Transduction
OR51S1	Signal Transduction
OR51T1	Signal Transduction
OR52B6	Signal Transduction
OR52B4	Signal Transduction
OR52E2	Signal Transduction
OR52E1	Signal Transduction
OR52E4	Signal Transduction
OR52E5	Signal Transduction
OR52H1	Signal Transduction
OR52I1	Signal Transduction
OR52I2	Signal Transduction
OR52J3	Signal Transduction
OR52K1	Signal Transduction
OR52K2	Signal Transduction
OR52L1	Signal Transduction
OR52L2P	Signal Transduction
OR52N1	Signal Transduction
OR52N2	Signal Transduction
OR52N4	Signal Transduction
OR52N5	Signal Transduction
OR51A2	Signal Transduction
OR51A4	Signal Transduction
OR51A7	Signal Transduction
OR51E1	Signal Transduction
OR51G2	Signal Transduction
OR51H1P	Signal Transduction
OR51F2	Signal Transduction
OR51G1	Signal Transduction
FANCL	DNA Repair
PCNA	Cell Cycle
PDCD6IP	Disease
PSENEN	A third proteolytic cleavage releases NICD
NRCAM	Developmental Biology
NPW	Signal Transduction
NPB	Signal Transduction
NUP54	Cell Cycle
NT5C	Metabolism
NT5M	Metabolism
RTEL1	Metabolism
NMNAT2	Disease
NELFCD	Disease
NELFB	Disease
NELFA	Disease
SLC24A4	Transmembrane transport of small molecules
NMNAT1	Disease
OR10G8	Signal Transduction
OR10G7	Signal Transduction
OR10H4	Signal Transduction
OR10G9	Signal Transduction
OR10G2	Signal Transduction
OR10AG1	Signal Transduction
OR10G4	Signal Transduction
OR10G3	Signal Transduction
OR10R2	Signal Transduction
OR10Q1	Signal Transduction
OR10J5	Signal Transduction
OR10H5	Signal Transduction
OR10K1	Signal Transduction
OR10J6P	Signal Transduction
OR9I1	Signal Transduction
OR9K2	Signal Transduction
OR9Q1	Signal Transduction
OR9A2	Signal Transduction
OR9A4	Signal Transduction
OR9G1	Signal Transduction
OR9G4	Signal Transduction
OR10AD1	Signal Transduction
OR10D4P	Signal Transduction
OR10A6	Signal Transduction
OR10A7	Signal Transduction
OR11G2	Signal Transduction
OR11L1	Signal Transduction
OR11H6	Signal Transduction
OR11H4	Signal Transduction
OR11H1	Signal Transduction
OR10T2	Signal Transduction
OR10S1	Signal Transduction
OR10Z1	Signal Transduction
OR10V1	Signal Transduction
OR6N1	Signal Transduction
OR6M1	Signal Transduction
OR6P1	Signal Transduction
OR6N2	Signal Transduction
OR6S1	Signal Transduction
OR6Q1	Signal Transduction
OR6V1	Signal Transduction
OR6T1	Signal Transduction
OR6Y1	Signal Transduction
OR6X1	Signal Transduction
OR7D2	Signal Transduction
OR7A2P	Signal Transduction
OR7G2	Signal Transduction
OR7G1	Signal Transduction
OR6B3	Signal Transduction
OR6C1	Signal Transduction
OR6C2	Signal Transduction
OR6C3	Signal Transduction
OR6C4	Signal Transduction
OR6F1	Signal Transduction
OR6J1	Signal Transduction
OR6K2	Signal Transduction
OR6K3	Signal Transduction
OR6K6	Signal Transduction
OR8H2	Signal Transduction
OR8H1	Signal Transduction
OR8G2	Signal Transduction
OR8G1	Signal Transduction
OR8J3	Signal Transduction
OR8J1	Signal Transduction
OR8I2	Signal Transduction
OR8H3	Signal Transduction
OR8K5	Signal Transduction
OR8K3	Signal Transduction
OR8K1	Signal Transduction
OR7G3	Signal Transduction
OR8B12	Signal Transduction
OR8D4	Signal Transduction
OR8A1	Signal Transduction
OR8B3	Signal Transduction
OR4K14	Signal Transduction
OR13C2	Signal Transduction
OR13C3	Signal Transduction
OR13C4	Signal Transduction
OR13C5	Signal Transduction
OR13C8	Signal Transduction
OR13C9	Signal Transduction
OR13A1	Signal Transduction
OR13J1	Signal Transduction
OR13H1	Signal Transduction
OR13G1	Signal Transduction
OR13D1	Signal Transduction
OR13F1	Signal Transduction
OR1F12	Signal Transduction
OR1J1	Signal Transduction
OR1J2	Signal Transduction
OR1J4	Signal Transduction
OR1B1	Signal Transduction
OR1F2P	Signal Transduction
OR1L4	Signal Transduction
OR1L6	Signal Transduction
OR1L8	Signal Transduction
OR1M1	Signal Transduction
OR1K1	Signal Transduction
OR1L1	Signal Transduction
OR1L3	Signal Transduction
OR1S2	Signal Transduction
OR1N2	Signal Transduction
OR1S1	Signal Transduction
OR1N1	Signal Transduction
OR2A7	Signal Transduction
OR2A14	Signal Transduction
OR2AE1	Signal Transduction
OR2A12	Signal Transduction
OR2A5	Signal Transduction
OR2A1	Signal Transduction
OR4N5	Signal Transduction
OR4N4	Signal Transduction
OR4N2	Signal Transduction
OR4M2	Signal Transduction
OR4M1	Signal Transduction
OR4L1	Signal Transduction
OR4K17	Signal Transduction
OR4K15	Signal Transduction
OR4K13	Signal Transduction
OR4K5	Signal Transduction
OR4K3	Signal Transduction
OR4K2	Signal Transduction
OR4K1	Signal Transduction
OR4F17	Signal Transduction
OR4F15	Signal Transduction
OR5AN1	Signal Transduction
OR5AP2	Signal Transduction
OR5AC2	Signal Transduction
OR5AK2	Signal Transduction
OR5A1	Signal Transduction
OR5A2	Signal Transduction
OR4X1	Signal Transduction
OR4X2	Signal Transduction
OR4S1	Signal Transduction
OR4S2	Signal Transduction
OR4P4	Signal Transduction
OR4Q3	Signal Transduction
OR5D18	Signal Transduction
OR5D16	Signal Transduction
OR5H6	Signal Transduction
OR5H2	Signal Transduction
OR5C1	Signal Transduction
OR5B17	Signal Transduction
OR5D14	Signal Transduction
OR5D13	Signal Transduction
OR14K1	Signal Transduction
OR14L1P	Signal Transduction
OR14C36	Signal Transduction
OR5B3	Signal Transduction
OR5AS1	Signal Transduction
OR5AR1	Signal Transduction
OR5AU1	Signal Transduction
OR14A16	Signal Transduction
OR5T3	Signal Transduction
OR5M8	Signal Transduction
OR5M9	Signal Transduction
OR5M11	Signal Transduction
OR5T2	Signal Transduction
OR5L1	Signal Transduction
OR5L2	Signal Transduction
OR5M1	Signal Transduction
OR5M3	Signal Transduction
OR5J2	Signal Transduction
OR5K1	Signal Transduction
OR5K2	Signal Transduction
OR5AK3P	Signal Transduction
OR2L8	Signal Transduction
OR2L2	Signal Transduction
OR2K2	Signal Transduction
OR2I1P	Signal Transduction
OR2M2	Signal Transduction
OR2L13	Signal Transduction
OR2L5	Signal Transduction
OR2C3	Signal Transduction
OR2B8P	Signal Transduction
OR2AK2	Signal Transduction
OR2G3	Signal Transduction
OR2G2	Signal Transduction
OR2D3	Signal Transduction
OR2Y1	Signal Transduction
OR2Z1	Signal Transduction
OR2V2	Signal Transduction
OR2M7	Signal Transduction
OR2T35	Signal Transduction
OR2M4	Signal Transduction
OR2M3	Signal Transduction
OR2T29	Signal Transduction
OR2T11	Signal Transduction
OR2T3	Signal Transduction
OR2T4	Signal Transduction
OR4A4P	Signal Transduction
OR4A15	Signal Transduction
OR4A5	Signal Transduction
OR4D5	Signal Transduction
OR4D6	Signal Transduction
OR4D9	Signal Transduction
OR4E2	Signal Transduction
OR4F4	Signal Transduction
OR4F5	Signal Transduction
OR4F6	Signal Transduction
OR4A16	Signal Transduction
OR4B1	Signal Transduction
OR4C3	Signal Transduction
OR4C6	Signal Transduction
OR4C12	Signal Transduction
OR4C13	Signal Transduction
OR4C15	Signal Transduction
OR4C16	Signal Transduction
GGT7	Metabolism
GFRA4	Developmental Biology
GMNN	Cell Cycle
GEMIN5	Gene Expression
GEMIN6	Gene Expression
GEMIN7	Gene Expression
LPAR5	Signal Transduction
HCAR1	Signal Transduction
P2RY13	Signal Transduction
TAAR3	Signal Transduction
OXGR1	Signal Transduction
TAAR2	Signal Transduction
RASGRP3	Immune System
GSTO2	Disease
HDAC8	Cell Cycle
FBXW8	Immune System
FEN1	Cell Cycle
FBLIM1	Cell-Cell communication
FLNC	Cell-Cell communication
FLNB	Immune System
GPR132	Signal Transduction
QRFPR	Signal Transduction
FZR1	Cell Cycle
FXYD4	Transmembrane transport of small molecules
FBXL5	Metabolism of proteins
FBXL3	Circadian Clock
FBXO27	Immune System
KHSRP	Gene Expression
GBP4	Immune System
GBP5	Immune System
GNG2	Hemostasis
INCENP	Cell Cycle
ITCH	Disease
ITPA	Metabolism
SUZ12	Cellular responses to stress
RPS6KA4	Developmental Biology
RPS6KA5	Developmental Biology
TNRC6B	Cellular responses to stress
KCND1	Neuronal System
KCND2	Neuronal System
KCND3	Neuronal System
Ig kappa chain V-IV region STH	Binding and Uptake of Ligands by Scavenger Receptors
HIF1AN	Cellular responses to stress
EIF4G2	Immune System
AGO3	Cellular responses to stress
AGO4	Cellular responses to stress
EIF4E2	Immune System
XRN2	Metabolism of proteins
SLC18A3	Neuronal System
UPP2	Metabolism
WEE1	Cell Cycle
WWP1	Immune System
BEST2	Transmembrane transport of small molecules
BEST4	Transmembrane transport of small molecules
BEST3	Transmembrane transport of small molecules
SLC32A1	Amino acid and oligopeptide SLC transporters
VRK1	Cell Cycle
ATP6V0A4	Disease
TAS2R5	Signal Transduction
TAS2R7	Signal Transduction
TAS2R4	Signal Transduction
TAS2R3	Signal Transduction
TAS2R1	Signal Transduction
TAS2R14	Signal Transduction
TAS2R16	Signal Transduction
TAS2R13	Signal Transduction
TAS2R10	Signal Transduction
TAS2R9	Signal Transduction
TAS2R8	Signal Transduction
TAAR9	Signal Transduction
TAAR8	Signal Transduction
TAAR6	Signal Transduction
TAAR1	Signal Transduction
TBC1D1	Membrane Trafficking
TFDP2	Cell Cycle
TFDP1	Apoptosis
TNN	Extracellular matrix organization
ALYREF	Gene Expression
THTPA	Disease
SUMF1	Metabolism
SUMF2	Metabolism of proteins
SUGT1	Immune System
SYT2	Disease
TDP1	DNA Repair
TXNDC5	Membrane Trafficking
UGT1A9	Metabolism
UGT1A7	Metabolism
UGT1A8	Metabolism
UGT2A1	Metabolism
TPI1	Disease
TPH2	Metabolism
MED20	Developmental Biology
TAS2R60	Signal Transduction
TRAF6	Immune System
TAS2R38	Signal Transduction
TAS2R40	Signal Transduction
TAS2R39	Signal Transduction
TAS2R43	Signal Transduction
TAS2R41	Signal Transduction
TAS2R45	Signal Transduction
TAS2R31	Signal Transduction
TAS2R30	Signal Transduction
TAS2R46	Signal Transduction
TAS2R20	Signal Transduction
TAS2R19	Signal Transduction
TAS2R50	Signal Transduction
TRIM9	Immune System
EPT1	Metabolism
SAV1	Signal Transduction
SEC61G	Gene Expression
RPE	Disease
SIRPG	Cell-Cell communication
SGPP1	Metabolism
SGPP2	Metabolism
SPCS3	Gene Expression
MED31	Developmental Biology
SIN3A	Gene Expression
SYNE1	Cell Cycle
SYNE2	Cell Cycle
SMC4	Cell Cycle
SMC2	Cell Cycle
SLIT2	Developmental Biology
INPP5K	Metabolism
PRMT5	Gene Expression
SKP1	Cell Cycle
SH3KBP1	Disease
SGPL1	Metabolism
PSMD7	Apoptosis
PSMD6	Apoptosis
PSMD4	Apoptosis
PSMD5	Apoptosis
PSMD3	Apoptosis
PSMD12	Apoptosis
PSMD13	Apoptosis
PSMD11	Apoptosis
PSMD10	Apoptosis
PSMD8	Apoptosis
PSMD9	Apoptosis
PSMB9	Apoptosis
PSMB8	Apoptosis
PSMB7	Apoptosis
PSMB6	Apoptosis
PSMD2	Apoptosis
PSMD1	Apoptosis
PSMB10	Apoptosis
GPR65	Signal Transduction
GINS2	Cell Cycle
PSMF1	Apoptosis
PSME2	Apoptosis
PSME1	Apoptosis
PSME3	Apoptosis
PTPRS	Extracellular matrix organization
ADSSL1	Metabolism
PRIM2	Cell Cycle
PRIM1	Cell Cycle
PSMC1	Apoptosis
PSMA1	Apoptosis
PSMA2	Apoptosis
PSMC6	Apoptosis
PSMC2	Apoptosis
PSMC4	Apoptosis
PSMC3	Apoptosis
PSMB3	Apoptosis
PSMB4	Apoptosis
PSMB5	Apoptosis
PSMB1	Apoptosis
PSMB2	Apoptosis
PSMA6	Apoptosis
PSMA7	Apoptosis
PSMA3	Apoptosis
PSMA4	Apoptosis
PSMA5	Apoptosis
PNPO	Disease
PJA1	Immune System
PROKR2	Signal Transduction
PROKR1	Signal Transduction
FERMT2	Cell-Cell communication
PELI1	Immune System
PELI2	Immune System
PELI3	Immune System
RFC4	Cell Cycle
RFC1	Cell Cycle
RPA4	Cell Cycle
RFC3	Cell Cycle
RFC2	Cell Cycle
RPA1	Cell Cycle
RPA3	Cell Cycle
RPA2	Cell Cycle
RIT2	Signal Transduction
RIT1	Signal Transduction
RIMS1	Neuronal System
RFK	Disease
RLN3	Signal Transduction
RALBP1	Signal Transduction
RBX1	Cellular responses to stress
RDH11	Disease
RDH12	Disease
RXFP4	Signal Transduction
CTDP1	Disease
ALKBH3	DNA Repair
ZNF473	Gene Expression
SLC39A2	Transmembrane transport of small molecules
SLC39A1	Transmembrane transport of small molecules
ZFP90	Gene Expression
ZFP28	Gene Expression
ZNF331	Gene Expression
ZNF431	Gene Expression
ZNF433	Gene Expression
ZSCAN32	Gene Expression
ZNF439	Gene Expression
ZNF426	Gene Expression
ZNF429	Gene Expression
ZNF430	Gene Expression
ZNF445	Gene Expression
ZNF440	Gene Expression
ZNF441	Gene Expression
ZNF442	Gene Expression
ZNF443	Gene Expression
ZNF479	Gene Expression
ZNF454	Gene Expression
ZNF471	Gene Expression
NT5C1B	Metabolism
NT5C1A	Metabolism
MDC1	DNA Repair
POLH	DNA Repair
hREV3	DNA Repair
MUTYH	DNA Repair
ZNF483	Gene Expression
F10	Hemostasis
BBC3	Apoptosis
BMF	Apoptosis
prgJ	Immune System
MAD1L1	Cell Cycle
MAD2L1	APC-Cdc20 mediated degradation of Nek2A
PAOX	Metabolism
LYRM4	Metabolism
HERC5	Immune System
CALCA	Signal Transduction
CTSE	Immune System
CNOT6	Gene Expression
BPNT1	Metabolism
BMP1	Extracellular matrix organization
DST	Cell-Cell communication
BSND	Transmembrane transport of small molecules
CD244	Hemostasis
CD226	Immune System
COL17A1	Cell-Cell communication
ADAMTS9	Extracellular matrix organization
BCS1L	Metabolism of proteins
ARNTL	Circadian Clock
ATRIP	Cell Cycle
ALG2	Metabolism of proteins
AGRN	Developmental Biology
ADM2	Signal Transduction
ALG12	Metabolism of proteins
AQP11	Transmembrane transport of small molecules
KDM1A	Hemostasis
ABCA12	Transmembrane transport of small molecules
ADRA2C	Hemostasis
ABI2	Immune System
HSD3B7	Metabolism
GSPT2	Gene Expression
SRGAP2	Developmental Biology
ZFPM1	Hemostasis
ZFPM2	Hemostasis
FBN3	Extracellular matrix organization
FBXW7	Disease
FBXW5	Metabolism of proteins
FANCE	DNA Repair
ERO1LB	Metabolism of proteins
ERO1L	Cellular responses to stress
CLINT1	Membrane Trafficking
EPN1	Disease
SMG6	Gene Expression
ERN1	Metabolism of proteins
EMR3	Signal Transduction
EMR2	Signal Transduction
EPM2A	Disease
S1PR4	Signal Transduction
DCTN1	Cell Cycle
EPS15L1	Disease
DZIP3	Immune System
DOLPP1	Metabolism of proteins
DHRS3	Disease
DBNL	Apoptosis
DAPP1	Immune System
CYLD	Immune System
SLC7A3	Amino acid and oligopeptide SLC transporters
C19orf10	Metabolism of proteins
COX15	Metabolism
CYP2W1	Metabolism
CNOT2	Gene Expression
CNOT3	Gene Expression
CNOT4	Gene Expression
CLDN23	Cell-Cell communication
KCNK16	Neuronal System
KCNMB4	Hemostasis
KCNMB3	Hemostasis
KCNMB2	Hemostasis
ZP1	Reproduction
ZNF486	Gene Expression
ZNF514	Gene Expression
ZNF500	Gene Expression
ZNF607	Gene Expression
ZNF519	Gene Expression
ZNF248	Gene Expression
ZP4	Reproduction
ZFYVE16	Signal Transduction
NUPL2	Cell Cycle
NUDC	Cell Cycle
RNPS1	Gene Expression
NFX.1	Gene Expression
NUP35	Cell Cycle
NUP85	Cell Cycle
VKORC1	Metabolism of proteins
BAAT	Metabolism
PIGW	Metabolism of proteins
PIGG	Metabolism of proteins
PGAP1	Metabolism of proteins
cDNA FLJ12769 fis, clone NT2RP2001581	Metabolism of proteins
PIGV	Metabolism of proteins
PIGN	Metabolism of proteins
PIGM	Metabolism of proteins
porB	Binding and Uptake of Ligands by Scavenger Receptors
DYNLL2	Apoptosis
TFB2M	Gene Expression
GORASP1	Cell Cycle
GANAB	Metabolism of proteins
FLVCR1	Transmembrane transport of small molecules
GALNT11	Metabolism of proteins
GALNT12	Metabolism of proteins
GALNT10	Metabolism of proteins
GRHPR	Metabolism
GAS6	Hemostasis
GAB2	Disease
GAB1	Disease
GPAA1	Metabolism of proteins
SUCNR1	Signal Transduction
GORASP2	Cell Cycle
GRIP1	Neuronal System
GRIP2	Neuronal System
GALNT13	Metabolism of proteins
GALNT14	Metabolism of proteins
GALNTL5	Metabolism of proteins
GALNT2	Metabolism of proteins
GALNT3	Metabolism of proteins
GALNT4	Metabolism of proteins
GALNT5	Metabolism of proteins
GALNT7	Metabolism of proteins
GALNT6	Metabolism of proteins
GALNT9	Metabolism of proteins
GALNT8	Metabolism of proteins
BLZF1	Cell Cycle
GNPNAT1	Metabolism of proteins
HEPH	Transmembrane transport of small molecules
MT-RNR2	Signal Transduction
GSTA5	Metabolism
GALNT16	Metabolism of proteins
WBSCR17	Metabolism of proteins
GALNT15	Metabolism of proteins
GALNT18	Metabolism of proteins
HIST1H2BK	Cell Cycle
HIST1H2BA	Cell Cycle
HIST3H2BB	Cell Cycle
EIF4G3	Immune System
HSCB	Metabolism of proteins
KCNJ14	Neuronal System
IRAK4	Immune System
PPA2	Gene Expression
INPP5E	Metabolism
IPMK	Metabolism
IP6K3	Metabolism
IP6K2	Immune System
IP6K1	Metabolism
RALGAPB	Membrane Trafficking
MAVS	Immune System
KCNMA1	Hemostasis
CCBL1	Disease
JAM3	Extracellular matrix organization
ERBB2IP	Signal Transduction
LRP10	Disease
LRP4	Extracellular matrix organization
LRP8	Disease
LATS2	Signal Transduction
LATS1	Signal Transduction
CERS6	Metabolism
CERS5	Metabolism
CERS3	Metabolism
CERS4	Metabolism
CERS2	Metabolism
LTBP3	Extracellular matrix organization
LTBP2	Extracellular matrix organization
LZTS1	Gene Expression
MBD2	Gene Expression
MCFD2	Metabolism of proteins
MEFV	Immune System
MFN2	Hemostasis
MFN1	Hemostasis
MGLL	Hemostasis
MAPKAPK5	Cellular responses to stress
MCOLN1	Transmembrane transport of small molecules
MCOLN2	Transmembrane transport of small molecules
MCOLN3	Transmembrane transport of small molecules
PPP1R12A	Cell Cycle
MUSK	Extracellular matrix organization
MUC15	Metabolism of proteins
MUC13	Metabolism of proteins
SLC9A9	Transmembrane transport of small molecules
SLC9A8	Transmembrane transport of small molecules
SLC9A7	Transmembrane transport of small molecules
ULBP1	Immune System
ULBP3	Immune System
NUP205	Cell Cycle
NDUFA11	Metabolism
NCR2	Immune System
NMNAT3	Disease
NHLRC1	Disease
NIPBL	Cell Cycle
NUP93	Cell Cycle
NUMA1	Cell Cycle
NRG1	Disease
OR2T34	Signal Transduction
OR2J1	Signal Transduction
OR10P1	Signal Transduction
OR10W1	Signal Transduction
BCAN	Disease
PIP4K2B	Metabolism
PACS1	Disease
PLA2G4C	Metabolism
CENPM	Cell Cycle
OSTM1	Transmembrane transport of small molecules
QRFP	Signal Transduction
PTDSS2	Metabolism
PPCS	Disease
PPARGC1A	Circadian Clock
POT1	Cell Cycle
PGR	Gene Expression
PARK2	Immune System
PLK4	Cell Cycle
BLOC1S6	Membrane Trafficking
PIGT	Metabolism of proteins
PAIP1	Gene Expression
HFE2	Developmental Biology
REC8	Cell Cycle
RGMB	Developmental Biology
RGMA	Developmental Biology
PLXNB1	Developmental Biology
PLXND1	Developmental Biology
PLXNB3	Developmental Biology
PUM1	Membrane Trafficking
SORBS1	Muscle contraction
STAB2	Binding and Uptake of Ligands by Scavenger Receptors
STAB1	Binding and Uptake of Ligands by Scavenger Receptors
UBA2	Metabolism of proteins
SLC6A20	Amine compound SLC transporters
SAE1	Metabolism of proteins
SLC6A14	Amine compound SLC transporters
SLC6A18	Amine compound SLC transporters
SLC40A1	Transmembrane transport of small molecules
SLC29A3	Transmembrane transport of small molecules
SLC36A1	Amino acid and oligopeptide SLC transporters
SLC38A3	Amino acid and oligopeptide SLC transporters
SLC22A4	Transmembrane transport of small molecules
SNAPIN	Membrane Trafficking
SLC17A5	Amino acid and oligopeptide SLC transporters
RXRB	Gene Expression
RPTOR	Cellular responses to stress
POLR3C	Gene Expression
ROCK1	Apoptosis
ROCK2	Developmental Biology
ROBO1	Developmental Biology
ROBO2	Developmental Biology
TRIM63	Immune System
ST3GAL6	Disease
ST8SIA6	Metabolism of proteins
ST6GALNAC3	Metabolism of proteins
SIAH2	Developmental Biology
SIAH1	Developmental Biology
SLIT1	Developmental Biology
SMARCA5	Cell Cycle
SGMS1	Metabolism
LARS	Gene Expression
ANO2	Transmembrane transport of small molecules
YARS2	Gene Expression
ANO3	Transmembrane transport of small molecules
CHMP5	Disease
SGMS2	Metabolism
TREM1	Hemostasis
TREM2	Developmental Biology
TPK1	Disease
UBE2E2	Immune System
UBE2J1	Immune System
UBE2J2	Immune System
UBE2E3	Immune System
UBA3	Immune System
UBE2V2	Immune System
UBE2V1	Immune System
HUWE1	Immune System
UNC5B	Apoptosis
UNC5C	Developmental Biology
UNC5D	Developmental Biology
UNC5A	Apoptosis
TREX1	Immune System
RAD9A	Cell Cycle
ACD	Cell Cycle
APOA5	Metabolism
CDC14A	Cell Cycle
CDC26	APC-Cdc20 mediated degradation of Nek2A
AFMID	Metabolism
NEK2	APC-Cdc20 mediated degradation of Nek2A
GINS4	Cell Cycle
RAD9B	Cell Cycle
SULT1B1	Metabolism
MAP2K3	Cellular responses to stress
TLR1	Immune System
THEM4	Disease
env	Disease
rev	Disease
gag-pol	Disease
nef	Disease
gag	Disease
TICAM2	Immune System
TBK1	Immune System
TICAM1	Immune System
vpr	Disease
vpu	Disease
tat	Disease
vif	Disease
XPO1	Cell Cycle
ALKBH2	DNA Repair
CLSPN	Apoptosis
HUS1	Cell Cycle
FRS2	Disease
NS	Disease
M	Disease
NP	Disease
HA	Disease
PB2	Disease
PB1	Disease
PA	Disease
NA	Disease
MAP2K6	Cellular responses to stress
fliC	Immune System
TLR9	Immune System
MAP3K7	Immune System
TAB2	Immune System
DDX58	Immune System
FRS3	Disease
GJA9	Membrane Trafficking
GJA10	Membrane Trafficking
GJC2	Membrane Trafficking
GJD4	Membrane Trafficking
GJD3	Membrane Trafficking
CH25H	Metabolism
SLC27A5	Metabolism
TGS1	Gene Expression
SNUPN	Gene Expression
PHAX	Gene Expression
TUBB	Cell Cycle
TUBB2A	Cell Cycle
TUBB6	Cell Cycle
TUBB2B	Cell Cycle
TUBB1	Cell Cycle
TUBB4B	Cell Cycle
TUBA4A	Cell Cycle
TUBA1B	Cell Cycle
TUBA1A	Cell Cycle
AMY1B	Disease
ARAP2	Signal Transduction
RACGAP1	Hemostasis
ARAP3	Signal Transduction
ARHGAP31	Signal Transduction
BPGAP1	Signal Transduction
GMIP	Signal Transduction
GDI1	Signal Transduction
GDI2	Signal Transduction
ARHGAP5	Signal Transduction
ARHGEF18	Disease
ARHGEF2	Signal Transduction
ARHGDIG	Signal Transduction
ARHGAP4	Signal Transduction
ARHGEF11	Developmental Biology
ARHGAP35	Developmental Biology
ARHGEF9	Neuronal System
ARHGAP44	Signal Transduction
RASGRF2	Neuronal System
MCF2L	Signal Transduction
PLEKHG2	Signal Transduction
PLEKHG5	Signal Transduction
TIAM1	Signal Transduction
ECT2	Signal Transduction
SORCS3	Signal Transduction
SQSTM1	Immune System
STAM	Disease
STAM2	Disease
HGS	Disease
VPS4A	Disease
CHMP2B	Disease
VPS25	Membrane Trafficking
CHMP4C	Disease
SNF8	Membrane Trafficking
VPS37B	Disease
PAG1	Disease
botD	Disease
botG	Disease
STX1B	Disease
botA	Disease
botF	Disease
Botulinum neurotoxin type C1	Disease
Botulinum neurotoxin type E	Disease
botB	Disease
MAPKAPK3	Cellular responses to stress
PIK3C3	Immune System
PIK3R4	Immune System
ZFYVE20	Hemostasis
TLR7	Immune System
CHMP3	Disease
CHMP6	Disease
VPS36	Membrane Trafficking
CHMP2A	Disease
CACNA2D1	Neuronal System
SLC17A7	Amino acid and oligopeptide SLC transporters
CACNA2D2	Metabolism
SLC1A7	Amino acid and oligopeptide SLC transporters
CACNA2D3	Neuronal System
SLC1A6	Amino acid and oligopeptide SLC transporters
SLC1A1	Amino acid and oligopeptide SLC transporters
CACNG2	Neuronal System
AGO2	Disease
CLEC5A	Immune System
RAB3A	Neuronal System
SLC1A2	Amino acid and oligopeptide SLC transporters
CACNG4	Neuronal System
SLC17A6	Amino acid and oligopeptide SLC transporters
CACNG3	Neuronal System
CPLX1	Neuronal System
CACNG8	Neuronal System
PAX4	Developmental Biology
CYP2R1	Metabolism
TAF9	Chromatin organization
MED25	Developmental Biology
TAF1B	Gene Expression
MED14	Developmental Biology
MAML2	Disease
TAF4	Disease
TAF13	Disease
MAML1	Disease
SLC38A2	Amino acid and oligopeptide SLC transporters
SLC38A1	Amino acid and oligopeptide SLC transporters
CYP4F22	Metabolism
CYP26C1	Metabolism
ARHGAP10	Apoptosis
HNF4A	Developmental Biology
AATF	Signal Transduction
GP6	Hemostasis
TRAT1	Disease
NOSTRIN	Metabolism
CER1	Developmental Biology
GREM2	Signal Transduction
CSNK2A1	Cell Cycle
SLC46A1	Disease
BNIP2	Developmental Biology
DEPDC1B	Signal Transduction
ARHGAP18	Signal Transduction
ARHGAP22	Signal Transduction
ARHGAP30	Signal Transduction
ARHGAP11A	Signal Transduction
ARHGAP40	Signal Transduction
ARHGAP19	Signal Transduction
PTF1A	Developmental Biology
ONECUT3	Developmental Biology
DOHH	Metabolism of proteins
EIF5A2	Metabolism of proteins
SLIT3	Developmental Biology
SEC31A	Immune System
NOSIP	Metabolism
LYPLA1	Metabolism
ZDHHC21	Metabolism
OLR1	Hemostasis
CD177	Hemostasis
CRTAM	Immune System
CADM3	Cell-Cell communication
CDKN1B	Cell Cycle
BTLA	Immune System
KLRG1	Immune System
CDON	Developmental Biology
DSCAML1	Cell-Cell communication
ESAM	Hemostasis
HCST	Immune System
GLYCAM1	Immune System
MICA	Immune System
NADSYN1	Disease
PPCDC	Disease
FLAD1	Disease
IGLV	Binding and Uptake of Ligands by Scavenger Receptors
IGKVA18	Binding and Uptake of Ligands by Scavenger Receptors
IGHV	Binding and Uptake of Ligands by Scavenger Receptors
IGHV7-81	Binding and Uptake of Ligands by Scavenger Receptors
IGLV2-23	Binding and Uptake of Ligands by Scavenger Receptors
IGLV11-55	Binding and Uptake of Ligands by Scavenger Receptors
IGLV3-27	Binding and Uptake of Ligands by Scavenger Receptors
IGLV10-54	Binding and Uptake of Ligands by Scavenger Receptors
IGLV7-46	Binding and Uptake of Ligands by Scavenger Receptors
IGLV7-43	Binding and Uptake of Ligands by Scavenger Receptors
IGLV5-45	Binding and Uptake of Ligands by Scavenger Receptors
IGLV3-22	Binding and Uptake of Ligands by Scavenger Receptors
IGLV2-11	Binding and Uptake of Ligands by Scavenger Receptors
IGLV4-69	Binding and Uptake of Ligands by Scavenger Receptors
IGLV3-25	Binding and Uptake of Ligands by Scavenger Receptors
IGLV3-12	Binding and Uptake of Ligands by Scavenger Receptors
IGLV2-33	Binding and Uptake of Ligands by Scavenger Receptors
IGLV5-37	Binding and Uptake of Ligands by Scavenger Receptors
IGLV4-3	Binding and Uptake of Ligands by Scavenger Receptors
IGLV8-61	Binding and Uptake of Ligands by Scavenger Receptors
IGLV1-40	Binding and Uptake of Ligands by Scavenger Receptors
IGLV1-44	Binding and Uptake of Ligands by Scavenger Receptors
IGLV4-60	Binding and Uptake of Ligands by Scavenger Receptors
IGLV3-16	Binding and Uptake of Ligands by Scavenger Receptors
IGLV2-18	Binding and Uptake of Ligands by Scavenger Receptors
IGLV1-36	Binding and Uptake of Ligands by Scavenger Receptors
SYDE2	Signal Transduction
ARHGAP11B	Signal Transduction
AKT1S1	Cellular responses to stress
AMDHD1	Metabolism
FOXO1	Developmental Biology
AASDHPPT	Disease
FOXO3	Developmental Biology
SLC19A3	Disease
PHLPP1	Disease
cd21	Immune System
IZUMO2	Reproduction
IZUMO4	Reproduction
SMG9	Gene Expression
CRB3	Cell-Cell communication
CRY1	Circadian Clock
CRY2	Circadian Clock
CATSPERG	Reproduction
ORAI1	Hemostasis
SMG8	Gene Expression
GJB7	Membrane Trafficking
MIS18BP1	Cell Cycle
CUX1	Disease
CUBN	Disease
CTRB2	Disease
CATSPER1	Reproduction
CATSPER2	Reproduction
CATSPER3	Reproduction
CATSPER4	Reproduction
CATSPERB	Reproduction
SLC44A5	Amine compound SLC transporters
SLC44A4	Amine compound SLC transporters
SLC44A3	Amine compound SLC transporters
SLC44A2	Amine compound SLC transporters
SLC44A1	Amine compound SLC transporters
CSTF3	Gene Expression
CSPG4	Disease
CSPG5	Disease
DEGS1	Metabolism
DEGS2	Metabolism
DCP1B	Gene Expression
DCP1A	Gene Expression
DCPS	Gene Expression
DCP2	Gene Expression
DCTN5	Immune System
DCTN4	Immune System
DCTN3	Cell Cycle
DDX11	Metabolism of proteins
DEFB134	Immune System
DEFB133	Immune System
DEFB136	Immune System
DEFB135	Immune System
DEFB128	Immune System
DEFB121	Immune System
DEFB132	Immune System
DEFB130	Immune System
DYNC2LI1	Immune System
CYBRD1	Transmembrane transport of small molecules
D2HGDH	Metabolism
DAK	Immune System
DEFB114	Immune System
DEFB113	Immune System
DEFB112	Immune System
DEFB110	Immune System
DEFB116	Immune System
DEFB115	Immune System
PDSS2	Metabolism
DNER	Disease
DHX36	Immune System
DHRS9	Disease
DET1	Immune System
HSD17B12	Metabolism
DAGLA	Hemostasis
DAGLB	Hemostasis
DGKH	Hemostasis
DGKK	Hemostasis
DGAT2	Metabolism
DTX4	Disease
DHFRL1	Disease
DYNC2H1	Immune System
APPL1	Apoptosis
DNM1L	Apoptosis
DOCK11	Hemostasis
PDSS1	Metabolism
DSEL	Disease
DSE	Disease
DPEP2	Metabolism
ELOVL7	Metabolism
ELOVL6	Metabolism
ELOVL5	Metabolism
ENPP7	Metabolism
ENOPH1	Metabolism
EDC3	Gene Expression
EDC4	Gene Expression
S1PR5	Signal Transduction
MRI1	Metabolism
EXOSC6	Gene Expression
EXOC8	Membrane Trafficking
AMER1	Signal Transduction
ERAP2	Immune System
ESCO1	Cell Cycle
ESCO2	Cell Cycle
ETHE1	Metabolism
FADS2	Metabolism
FADS1	Metabolism
FAR2	Metabolism
FAR1	Metabolism
FANCD2	DNA Repair
FANCB	DNA Repair
FANCI	DNA Repair
FARP2	Developmental Biology
FAAP24	DNA Repair
FANCM	DNA Repair
BRIP1	Metabolism
CNOT11	Gene Expression
MMADHC	Disease
UNC80	Transmembrane transport of small molecules
CASC5	Cell Cycle
CARM1	Metabolism
CPB2	Metabolism of proteins
CCAR1	Gene Expression
CD320	Disease
CDK19	Developmental Biology
SPDL1	Cell Cycle
CCRL2	Signal Transduction
CEP152	Cell Cycle
CEP164	Cell Cycle
CDCA5	Cell Cycle
APITD1	Cell Cycle
CENPT	Cell Cycle
MLF1IP	Cell Cycle
CENPO	Cell Cycle
CENPP	Cell Cycle
CENPQ	Cell Cycle
CEP57	Cell Cycle
CEP63	Cell Cycle
HAUS2	Cell Cycle
CEP41	Cell Cycle
CEPT1	Metabolism
CEP72	Cell Cycle
CEP70	Cell Cycle
CEP76	Cell Cycle
CEP78	Cell Cycle
CEP192	Cell Cycle
CENPN	Cell Cycle
CENPL	Cell Cycle
CENPK	Cell Cycle
CENPJ	Cell Cycle
CENPH	Cell Cycle
CSGALNACT1	Disease
MB21D1	Immune System
CSGALNACT2	Disease
CHSY1	Disease
CHPT1	Metabolism
CHST2	Disease
CHST3	Disease
CHPF	Disease
CHST1	Disease
CHSY3	Disease
CHL1	Developmental Biology
CHMP7	Disease
CHPF2	Disease
CHD9	Metabolism
CHST13	Disease
CHST14	Disease
CHST12	Disease
CHST11	Disease
CHST7	Disease
CHST6	Disease
CHST5	Disease
TOMM5	Metabolism of proteins
CLASP2	Cell Cycle
CLASP1	Cell Cycle
CD207	Immune System
CD300LB	Immune System
CD300E	Immune System
CNPY3	Immune System
CNOT10	Gene Expression
CNOT1	Gene Expression
CNOT6L	Gene Expression
CNTN6	Developmental Biology
C4B	Immune System
C4A	Immune System
COL13A1	Extracellular matrix organization
COL14A1	Extracellular matrix organization
COLEC11	Binding and Uptake of Ligands by Scavenger Receptors
COLEC12	Binding and Uptake of Ligands by Scavenger Receptors
COL21A1	Extracellular matrix organization
COL22A1	Extracellular matrix organization
COL23A1	Extracellular matrix organization
COL24A1	Extracellular matrix organization
COL25A1	Extracellular matrix organization
COQ2	Metabolism
COQ5	Metabolism
COL27A1	Extracellular matrix organization
COL28A1	Extracellular matrix organization
CEP135	Cell Cycle
CNTRL	Cell Cycle
CPSF6	Disease
CIAPIN1	Metabolism
ADAL	Metabolism
ACSM2B	Metabolism
ACSM2A	Metabolism
POTEKP	Hemostasis
ACVR1C	Developmental Biology
ACSM1	Metabolism
ACSM5	Metabolism
SLC33A1	Transmembrane transport of small molecules
ACE2	Metabolism of proteins
ASIC3	Transmembrane transport of small molecules
ABHD5	Metabolism
ABCC11	Transmembrane transport of small molecules
ABCB5	Transmembrane transport of small molecules
ABLIM3	Developmental Biology
ABLIM1	Developmental Biology
ABLIM2	Developmental Biology
APBB1IP	Hemostasis
ABCA8	Transmembrane transport of small molecules
ABCA9	Transmembrane transport of small molecules
ABCA6	Transmembrane transport of small molecules
ABCA7	Transmembrane transport of small molecules
PPP2R2D	Cell Cycle
HLA-DRB5	Immune System
HTR3B	Transmembrane transport of small molecules
HTR3C	Transmembrane transport of small molecules
HTR3D	Transmembrane transport of small molecules
HTR3E	Transmembrane transport of small molecules
RAD51C	Hemostasis
ABL1	Developmental Biology
ARHGEF17	Signal Transduction
APIP	Metabolism
ANKRD1	Metabolism
ANAPC13	Immune System
AMOTL2	Signal Transduction
ALMS1	Cell Cycle
AMOTL1	Signal Transduction
ALG13	Metabolism of proteins
ALG11	Metabolism of proteins
ALG1	Metabolism of proteins
ALG14	Metabolism of proteins
ALG9	Metabolism of proteins
STRADB	Signal Transduction
AHCTF1	Cell Cycle
ALG10B	Metabolism of proteins
ALG10	Metabolism of proteins
FDX1L	Metabolism
BLOC1S3	Membrane Trafficking
AZI1	Cell Cycle
DNAJC6	Membrane Trafficking
B9D2	Cell Cycle
B3GNT6	Metabolism of proteins
B3GNT8	Metabolism of proteins
B3GNT7	Disease
B3GNT4	Disease
B3GNT5	Metabolism of proteins
B3GALT6	Disease
B3GNTL1	Metabolism of proteins
ASPSCR1	Membrane Trafficking
ATG7	Immune System
KIDINS220	Signal Transduction
ARTN	Developmental Biology
ARSK	Metabolism
ARSJ	Metabolism
ARSH	Metabolism
ARSI	Metabolism
ARSG	Metabolism
ACER2	Metabolism
RALGAPA2	Membrane Trafficking
ASAH2	Metabolism
ACER1	Metabolism
ASB18	Immune System
ASF1A	Cellular responses to stress
RNF220	Immune System
CADM2	Cell-Cell communication
CADM1	Cell-Cell communication
CABLES1	Hemostasis
FAM213B	Metabolism
CD163	Binding and Uptake of Ligands by Scavenger Receptors
C1GALT1	Metabolism of proteins
C1GALT1C1	Metabolism of proteins
CDCA8	Cell Cycle
BORA	Cell Cycle
MED4	Developmental Biology
MED30	Developmental Biology
RANBP9	Developmental Biology
RCOR1	Hemostasis
RCC2	Cell Cycle
RDH10	Disease
RDH16	Disease
RFT1	Metabolism of proteins
RAB11FIP2	Transmembrane transport of small molecules
RFWD2	Cell Cycle
UPF3A	Gene Expression
UPF3B	Gene Expression
UPF2	Gene Expression
RICTOR	Disease
RHOV	Signal Transduction
RHOU	Signal Transduction
RNF2	Cellular responses to stress
RILP	Immune System
ARHGAP15	Signal Transduction
RHBG	Amine compound SLC transporters
RHCG	Amine compound SLC transporters
ARHGAP29	Signal Transduction
PRKRA	Gene Expression
PPARGC1B	Metabolism
PPP1R15A	Disease
PSME4	Apoptosis
PSMB11	Apoptosis
PRPF8	Gene Expression
CTPS2	Metabolism
PVRL4	Cell-Cell communication
PEX11A	Metabolism
PTRF	Gene Expression
PTPMT1	Metabolism
RAD1	Cell Cycle
RGS9BP	Disease
RNF144B	Immune System
PIP5K1A	Metabolism
PIP5K1B	Metabolism
PIP5K1C	Developmental Biology
PIK3R5	Hemostasis
PIK3R6	Hemostasis
PIGB	Metabolism of proteins
PIGX	Metabolism of proteins
PJA2	Immune System
PLBD1	Metabolism
PLB1	Disease
PLCD3	Metabolism
PLCE1	Metabolism
LPCAT4	Metabolism
AGPAT6	Metabolism
AGPAT9	Metabolism
PLD4	Immune System
PLD3	Immune System
PNPLA8	Metabolism
PNPLA2	Metabolism
PMF1	Cell Cycle
PLXNA1	Developmental Biology
PLXNA2	Developmental Biology
PLXNA4	Developmental Biology
PLXNC1	Developmental Biology
GPAT2	Metabolism
NAPRT1	Disease
NUP210	Cell Cycle
PORCN	Signal Transduction
PPAPDC1A	Immune System
PSTPIP1	Immune System
PPAPDC1B	Immune System
PPP1R3C	Disease
PPM1L	Metabolism
PATL1	Gene Expression
PARN	Gene Expression
LPCAT1	Metabolism
LPCAT2	Metabolism
PDE11A	Hemostasis
PCM1	Cell Cycle
PDS5A	Cell Cycle
PDGFD	Signal Transduction
PDS5B	Cell Cycle
PGM2	Disease
PHF21A	Hemostasis
PHLPP2	Disease
PHOSPHO1	Metabolism
PHC2	Cellular responses to stress
PHC3	Cellular responses to stress
OR5G3	Signal Transduction
OR5B21	Signal Transduction
OR5K3	Signal Transduction
OR5H1	Signal Transduction
OR4E1	Signal Transduction
OR4D11	Signal Transduction
OR4Q2	Signal Transduction
OR4F3	Signal Transduction
OR4C5	Signal Transduction
OR4A8P	Signal Transduction
OR4D10	Signal Transduction
OR4C11	Signal Transduction
OR2T8	Signal Transduction
OR2T6	Signal Transduction
OR2W3	Signal Transduction
OR2V1	Signal Transduction
OR2L3	Signal Transduction
OR2M5	Signal Transduction
OR2T2	Signal Transduction
OR2T5	Signal Transduction
OR1P1	Signal Transduction
OR2A2	Signal Transduction
OR2B11	Signal Transduction
OR2G6	Signal Transduction
OR1E3	Signal Transduction
OPTN	Cell Cycle
OPN5	Signal Transduction
ODAM	Disease
TOMM6	Metabolism of proteins
ODF2	Cell Cycle
NUF2	Cell Cycle
OR6C76	Signal Transduction
OR7E24	Signal Transduction
OR6C74	Signal Transduction
OR6C75	Signal Transduction
OR6C68	Signal Transduction
OR6C70	Signal Transduction
OR5H15	Signal Transduction
OR6C65	Signal Transduction
OR14I1	Signal Transduction
OR5H14	Signal Transduction
OR5AC1	Signal Transduction
OR5AL1	Signal Transduction
OR52Z1	Signal Transduction
OR56B1	Signal Transduction
OR52M1	Signal Transduction
OR52W1	Signal Transduction
OR2A25	Signal Transduction
OR2AG2	Signal Transduction
OR2AJ1	Signal Transduction
OR2AP1	Signal Transduction
OR10J4	Signal Transduction
OR10K2	Signal Transduction
OR10X1	Signal Transduction
OR11H7	Signal Transduction
OR10A2	Signal Transduction
OR10G6	Signal Transduction
OR10J3	Signal Transduction
OR52A4	Signal Transduction
OR51V1	Signal Transduction
OR52E8	Signal Transduction
OR52A5	Signal Transduction
OR51B6	Signal Transduction
OR51B5	Signal Transduction
OR51F1	Signal Transduction
OR51D1	Signal Transduction
OR4A47	Signal Transduction
OR2T33	Signal Transduction
OR4C46	Signal Transduction
OR4C45	Signal Transduction
OR2T10	Signal Transduction
OR2AT4	Signal Transduction
OR2T27	Signal Transduction
OR2T12	Signal Transduction
NUDT10	Metabolism
NUP188	Cell Cycle
NUDT4	Metabolism
NUDT3	Metabolism
NUDT11	Metabolism
NUDT15	Metabolism
NUDT16	Metabolism
PALB2	DNA Repair
PAN3	Gene Expression
PAN2	Gene Expression
LEPRE1	Extracellular matrix organization
PIK3C2A	Membrane Trafficking
LEPREL2	Extracellular matrix organization
LEPREL1	Extracellular matrix organization
PI4K2B	Metabolism
PI4K2A	Metabolism
PLA2G4D	Metabolism
PLA2G4E	Metabolism
PLA2G4F	Metabolism
OTUD5	Immune System
OXER1	Signal Transduction
OR6B2	Signal Transduction
OR5W2	Signal Transduction
OR7D4	Signal Transduction
OR6C6	Signal Transduction
OR5M10	Signal Transduction
OR5K4	Signal Transduction
OR5T1	Signal Transduction
OR5R1	Signal Transduction
OR9Q2	Signal Transduction
OR8J2	Signal Transduction
OR8G5	Signal Transduction
OR8U1	Signal Transduction
OR8S1	Signal Transduction
HS3ST1	Disease
HS3ST2	Disease
HS3ST3A1	Disease
HS3ST4	Disease
HS3ST3B1	Disease
HS3ST6	Disease
HS3ST5	Disease
NR2C2AP	Gene Expression
SLC34A2	Transmembrane transport of small molecules
SLC34A3	Transmembrane transport of small molecules
NPSR1	Signal Transduction
NPS	Signal Transduction
NMUR2	Signal Transduction
NMS	Signal Transduction
NMUR1	Signal Transduction
NINL	Cell Cycle
NLRX1	Immune System
NLRC5	Immune System
LAT2	Immune System
SMPD3	Metabolism
SMPD4	Metabolism
NRBP1	Gene Expression
SLC24A5	Transmembrane transport of small molecules
SLC24A6	Transmembrane transport of small molecules
NDC80	Cell Cycle
NDEL1	Cell Cycle
NDE1	Cell Cycle
NDST4	Disease
NDST3	Disease
NDOR1	Metabolism
NARFL	Metabolism
NAPEPLD	Disease
NTN4	Developmental Biology
NTN3	Developmental Biology
NEURL	Disease
SLC9B1	Transmembrane transport of small molecules
NEDD4L	Disease
NEDD1	Cell Cycle
NECAP1	Membrane Trafficking
MRVI1	Hemostasis
ABCC10	Transmembrane transport of small molecules
MRC2	Immune System
MTMR4	Disease
MST4	Apoptosis
MOB1A	Signal Transduction
MOB1B	Signal Transduction
MOCOS	Disease
SLC16A10	Amino acid and oligopeptide SLC transporters
NALCN	Transmembrane transport of small molecules
MUC16	Metabolism of proteins
MUC3B	Metabolism of proteins
MUC20	Metabolism of proteins
MUC17	Metabolism of proteins
ADI1	Metabolism
MTMR14	Metabolism
MYH15	Membrane Trafficking
MYH14	Developmental Biology
MUCL1	Metabolism of proteins
MUC6	Metabolism of proteins
MUC7	Metabolism of proteins
MGRN1	Immune System
SLC25A28	Metabolism
SLC25A37	Metabolism
MED9	Developmental Biology
MED29	Developmental Biology
MMS19	Metabolism
MMACHC	Disease
MIS12	Cell Cycle
MINPP1	Metabolism
MIB2	Disease
MIB1	Disease
CHCHD4	Metabolism of proteins
MGAT4B	Metabolism of proteins
MGAT4A	Metabolism of proteins
MGAT4C	Metabolism of proteins
MAT2B	Metabolism
MBOAT2	Metabolism
MBOAT1	Metabolism
MBOAT7	Metabolism
MBOAT4	Metabolism of proteins
LPCAT3	Metabolism
MASTL	Cell Cycle
MAML3	Disease
MANEA	Metabolism of proteins
MED19	Developmental Biology
MED18	Developmental Biology
MED11	Developmental Biology
MED10	Developmental Biology
MED13L	Developmental Biology
MCM10	Cell Cycle
LRRFIP1	Disease
LRRC16A	Hemostasis
undefined	Disease
lpdC	Disease
LCLAT1	Metabolism
LYVE1	Disease
LRSAM1	Immune System
LTBP4	Extracellular matrix organization
LIMS2	Cell-Cell communication
LIN37	Cell Cycle
LEMD2	Cell Cycle
LMBRD1	Disease
secA1	Disease
Rv2895c	Disease
dlaT	Disease
secY	Disease
LIN9	Cell Cycle
secD	Disease
LIN52	Cell Cycle
secG	Disease
sodC	Disease
ahpC	Disease
irtB	Disease
irtA	Disease
tpx	Disease
secE	Disease
secA2	Disease
katG	Disease
msrA	Disease
trxB	Disease
secF	Disease
sodB	Disease
LONP2	Metabolism of proteins
ahpD	Disease
glbN	Disease
KLB	Disease
POGLUT1	Signal Transduction
L2HGDH	Metabolism
KRBA1	Gene Expression
SLC43A1	Amino acid and oligopeptide SLC transporters
SLC43A2	Amino acid and oligopeptide SLC transporters
LDHD	Metabolism of proteins
CCBL2	Metabolism
KCNA10	Neuronal System
KCNK18	Neuronal System
KCNA7	Neuronal System
KCNV1	Neuronal System
KIF26A	Hemostasis
KIF18A	Cell Cycle
CAMKK1	Neuronal System
KISS1R	Signal Transduction
KIF2B	Cell Cycle
KIF4B	Developmental Biology
KLHDC3	Metabolism of proteins
KLC3	Hemostasis
MAU2	Cell Cycle
UNC79	Transmembrane transport of small molecules
ANKLE2	Cell Cycle
KDM6B	Cellular responses to stress
AJUBA	Cell Cycle
SPAG9	Developmental Biology
ITPK1	Hemostasis
IRS4	Signal Transduction
ISG20	Immune System
IPPK	Metabolism
ITPKC	Metabolism
INSIG2	Metabolism
INPP4B	Metabolism
INPP4A	Metabolism
ISYNA1	Metabolism
INADL	Cell-Cell communication
KPNA7	Immune System
EIF4E3	Immune System
IFIH1	Immune System
IGF2BP1	Gene Expression
IGF2BP2	Gene Expression
IGF2BP3	Gene Expression
IDO2	Metabolism
HYAL3	Disease
HYAL1	Disease
HNRNPUL1	Gene Expression
ADHFE1	Metabolism
HPSE2	Disease
HPSE	Disease
HS2ST1	Disease
HJURP	Cell Cycle
HMG20B	Hemostasis
HES5	Disease
HERC2	Immune System
HIF3A	Cellular responses to stress
HEYL	Disease
HEY2	Disease
HECTD3	Immune System
HEBP1	Signal Transduction
HS6ST3	Disease
HS6ST1	Disease
HS6ST2	Disease
H2AFZ	Cell Cycle
H2AFB1	Cell Cycle
HBG2	Hemostasis
HBA1	Binding and Uptake of Ligands by Scavenger Receptors
HBB	Binding and Uptake of Ligands by Scavenger Receptors
HBG1	Hemostasis
HABP4	Hemostasis
RASGRP1	Hemostasis
RASGRP2	Hemostasis
RASGRP4	Immune System
SLC2A7	Transmembrane transport of small molecules
SLC2A12	Transmembrane transport of small molecules
HSD17B6	Disease
HIST2H2AA3	Cell Cycle
COLGALT1	Extracellular matrix organization
COLGALT2	Extracellular matrix organization
GPR55	Signal Transduction
WLS	Signal Transduction
GPC2	Disease
GPD1L	Metabolism
GPRC6A	Signal Transduction
GPBAR1	Signal Transduction
GRHL1	Metabolism
GLYAT	Metabolism
GLYATL2	Metabolism
GLYATL1	Metabolism
GMPPB	Metabolism of proteins
GALNTL6	Metabolism of proteins
FFAR4	Signal Transduction
GGT6	Metabolism
GXYLT2	Disease
GLB1L	Disease
GXYLT1	Disease
GBA2	Metabolism
GBA3	Metabolism
GBP7	Immune System
GBP6	Immune System
GCNT7	Metabolism of proteins
GCNT6	Metabolism of proteins
GCNT4	Metabolism of proteins
GCNT3	Metabolism of proteins
ARHGEF25	Signal Transduction
HCAR2	Signal Transduction
FGFR1OP	Cell Cycle
FAAP100	DNA Repair
FBXW10	Metabolism of proteins
FBXW9	Metabolism of proteins
FGFR1OP2	Disease
SLC30A8	Transmembrane transport of small molecules
ZWILCH	Cell Cycle
YIPF6	Membrane Trafficking
PLD6	Metabolism
ZFP1	Gene Expression
ZFP2	Gene Expression
ZIK1	Gene Expression
ZNF343	Gene Expression
ZNF311	Gene Expression
ZNF320	Gene Expression
ZNF233	Gene Expression
ZNF227	Gene Expression
ZKSCAN7	Gene Expression
ZNF101	Gene Expression
ZNF114	Gene Expression
ZNF100	Gene Expression
ZNF285	Gene Expression
ZNF354B	Gene Expression
ZNF324B	Gene Expression
ZNF354C	Gene Expression
ZBTB32	DNA Repair
ZNF585A	Gene Expression
ZNF804B	Gene Expression
ZNF658B	Gene Expression
ZNF585B	Gene Expression
ZNF705A	Gene Expression
ZNF641	Gene Expression
ZFP69	Gene Expression
ZFP69B	Gene Expression
ZNF649	Gene Expression
ZNF627	Gene Expression
ZNF665	Gene Expression
ZNF667	Gene Expression
ZNF668	Gene Expression
ZNF669	Gene Expression
ZNF670	Gene Expression
ZNF671	Gene Expression
KRBOX4	Gene Expression
ZNF658	Gene Expression
ZNF655	Gene Expression
ZNF660	Gene Expression
ZNF662	Gene Expression
ZNF664	Gene Expression
ZNF691	Gene Expression
ZNF689	Gene Expression
ZNF679	Gene Expression
ZNF678	Gene Expression
ZNF677	Gene Expression
ZNF676	Gene Expression
ZNF675	Gene Expression
ZNF684	Gene Expression
ZNF682	Gene Expression
ZNF681	Gene Expression
ZNF680	Gene Expression
ZNF707	Gene Expression
ZNF709	Gene Expression
ZNF710	Gene Expression
ZNF704	Gene Expression
ZNF706	Gene Expression
ZNF713	Gene Expression
ZNF718	Gene Expression
ZNF721	Gene Expression
ZNF692	Gene Expression
ZNF701	Gene Expression
ZNF700	Gene Expression
ZNF703	Gene Expression
ZNF702P	Gene Expression
ZNF697	Gene Expression
ZNF696	Gene Expression
ZNF699	Gene Expression
ZNF771	Gene Expression
ZNF770	Gene Expression
ZNF773	Gene Expression
ZNF772	Gene Expression
ZNF764	Gene Expression
ZNF767	Gene Expression
ZNF749	Gene Expression
ZNF747	Gene Expression
ZNF75A	Gene Expression
ZNF761	Gene Expression
ZNF750	Gene Expression
ZNF738	Gene Expression
ZNF740	Gene Expression
ZNF746	Gene Expression
ZNF793	Gene Expression
ZNF792	Gene Expression
ZNF799	Gene Expression
ZNF791	Gene Expression
ZNF790	Gene Expression
ZNF782	Gene Expression
ZNF786	Gene Expression
ZNF774	Gene Expression
ZNF775	Gene Expression
ZNF776	Gene Expression
ZNF777	Gene Expression
ZNF778	Gene Expression
ZNF34	Gene Expression
ZNF2	Gene Expression
SLC30A7	Metabolism of proteins
SLC30A2	Transmembrane transport of small molecules
ZNF350	Gene Expression
ZNF383	Gene Expression
ZNF394	Gene Expression
ZNF415	Gene Expression
ZNF416	Gene Expression
ZNF420	Gene Expression
ZNF419	Gene Expression
ZNF417	Gene Expression
ZNF425	Gene Expression
ZNF446	Gene Expression
ZNF468	Gene Expression
ZNF480	Gene Expression
ZNF484	Gene Expression
ZNF470	Gene Expression
ZSCAN25	Gene Expression
ZNF485	Gene Expression
ZNF493	Gene Expression
ZNF496	Gene Expression
ZNF506	Gene Expression
ZNF517	Gene Expression
ZNF529	Gene Expression
ZNF528	Gene Expression
ZNF540	Gene Expression
ZNF530	Gene Expression
ZNF546	Gene Expression
ZNF547	Gene Expression
ZNF548	Gene Expression
ZNF549	Gene Expression
ZNF543	Gene Expression
ZNF544	Gene Expression
ZNF554	Gene Expression
ZNF555	Gene Expression
ZNF556	Gene Expression
ZNF557	Gene Expression
ZNF550	Gene Expression
ZNF551	Gene Expression
ZNF552	Gene Expression
ZNF566	Gene Expression
ZNF564	Gene Expression
ZNF565	Gene Expression
ZNF568	Gene Expression
ZNF567	Gene Expression
ZNF560	Gene Expression
ZNF561	Gene Expression
ZNF558	Gene Expression
ZNF559	Gene Expression
ZNF563	Gene Expression
ZNF562	Gene Expression
ZNF570	Gene Expression
ZNF569	Gene Expression
ZNF573	Gene Expression
ZNF571	Gene Expression
ZNF584	Gene Expression
ZNF586	Gene Expression
ZNF587	Gene Expression
ZNF589	Gene Expression
ZNF582	Gene Expression
ZNF583	Gene Expression
ZNF577	Gene Expression
ZNF599	Gene Expression
ZNF596	Gene Expression
ZNF597	Gene Expression
ZNF595	Gene Expression
ZNF614	Gene Expression
ZNF611	Gene Expression
ZNF613	Gene Expression
ZNF610	Gene Expression
ZNF605	Gene Expression
ZNF600	Gene Expression
ZNF626	Gene Expression
ZNF625	Gene Expression
ZNF621	Gene Expression
ZNF620	Gene Expression
ZNF619	Gene Expression
ZNF616	Gene Expression
ZNF615	Gene Expression
VPRBP	Immune System
VPS37C	Disease
VPS37A	Disease
PPIP5K2	Metabolism
PPIP5K1	Metabolism
ATP6V1E2	Disease
ATP6V1C2	Disease
VAMP8	Membrane Trafficking
VAC14	Metabolism
ATP6V0D2	Disease
ATP6V0E2	Disease
UTS2B	Signal Transduction
UST	Disease
XRN1	Gene Expression
WWOX	Signal Transduction
WWTR1	Disease
WWC1	Signal Transduction
WIPI1	Metabolism of proteins
SNRNP40	Gene Expression
WAPAL	Cell Cycle
YIF1A	Metabolism of proteins
ZNF716	Gene Expression
TPTE2	Metabolism
TRIM56	Immune System
TRIM37	Immune System
TRIM36	Immune System
TRPM4	Transmembrane transport of small molecules
TRPA1	Transmembrane transport of small molecules
TRPV6	Transmembrane transport of small molecules
TRPV5	Transmembrane transport of small molecules
TRPV4	Transmembrane transport of small molecules
TRPV3	Transmembrane transport of small molecules
TRPV2	Transmembrane transport of small molecules
TRPV1	Transmembrane transport of small molecules
TRPM8	Transmembrane transport of small molecules
TRPM7	Transmembrane transport of small molecules
TRPM6	Transmembrane transport of small molecules
TAS1R3	Signal Transduction
TAS1R2	Signal Transduction
TAS1R1	Signal Transduction
TNIP2	Immune System
TNRC6C	Cellular responses to stress
TNRC6A	Cellular responses to stress
TPCN2	Transmembrane transport of small molecules
TPCN1	Transmembrane transport of small molecules
UBE2U	Immune System
UBE2W	Immune System
UBE2T	DNA Repair
UBE3B	Immune System
UBE2Z	Immune System
UBE3C	Immune System
UBE2O	Immune System
UBE2F	Immune System
UBE2Q1	Immune System
UBE2Q2	Immune System
UBE2R2	Immune System
UBA5	Immune System
UBA6	Immune System
UBE2D4	Immune System
UBR2	Immune System
UBR1	Immune System
UBR4	Immune System
UBN1	Cellular responses to stress
UGGT1	Metabolism of proteins
UNC93B1	Immune System
TSPYL2	Metabolism of proteins
TTYH2	Transmembrane transport of small molecules
TTYH3	Transmembrane transport of small molecules
TXNIP	Immune System
TAX1BP1	Immune System
TAOK1	Cell Cycle
TBCD	Metabolism of proteins
TBCE	Metabolism of proteins
AARS2	Gene Expression
EARS2	Gene Expression
DARS2	Gene Expression
SYCE2	Cell Cycle
SYCE1	Cell Cycle
SYCP3	Cell Cycle
CARS2	Gene Expression
IARS2	Gene Expression
MARS2	Gene Expression
FARS2	Gene Expression
NARS2	Gene Expression
TAS2R42	Signal Transduction
TAAR5	Signal Transduction
TAB3	Immune System
RARS2	Gene Expression
PARS2	Gene Expression
SYVN1	Metabolism of proteins
TARS2	Gene Expression
TMEM173	Immune System
ANO9	Transmembrane transport of small molecules
ANO10	Transmembrane transport of small molecules
ANO8	Transmembrane transport of small molecules
ANO7	Transmembrane transport of small molecules
ANO6	Transmembrane transport of small molecules
ANO5	Transmembrane transport of small molecules
ANO4	Transmembrane transport of small molecules
ANO1	Transmembrane transport of small molecules
CATSPERD	Reproduction
TNR	Extracellular matrix organization
TTN	Hemostasis
TLL1	Extracellular matrix organization
TLL2	Extracellular matrix organization
TIMM50	Metabolism of proteins
PTH2	Signal Transduction
TIMM21	Metabolism of proteins
DNAJC19	Metabolism of proteins
SMG5	Gene Expression
SMG1	Gene Expression
SMARCD3	Metabolism
SMUG1	DNA Repair
SNAPC4	Gene Expression
SIKE1	Immune System
SIGLEC14	Immune System
SIGLEC15	Immune System
SKA2	Cell Cycle
SKA1	Cell Cycle
SKAP2	Cell-Cell communication
SLC9A4	Transmembrane transport of small molecules
SH2B1	Hemostasis
SGOL2	Cell Cycle
SGOL1	Cell Cycle
INPP5D	Hemostasis
SH3D19	Membrane Trafficking
KIAA1598	Developmental Biology
INPPL1	Immune System
SEMA6D	Developmental Biology
SERP1	Metabolism of proteins
SUGP1	Gene Expression
STEAP3	Transmembrane transport of small molecules
STEAP2	Transmembrane transport of small molecules
CHST15	Disease
STUB1	Disease
STRADA	Signal Transduction
STRA6	Disease
SRRM1	Gene Expression
SPSB4	Immune System
SPSB1	Immune System
SPSB2	Immune System
SUPT16H	Disease
SLC10A6	Bile salt and organic anion SLC transporters
SPC25	Cell Cycle
SPC24	Cell Cycle
RSF1	Cell Cycle
RAP1GAP2	Immune System
POLR3G	Gene Expression
POLR3GL	Gene Expression
RNF19B	Immune System
RNF182	Immune System
RNF34	Immune System
RNF41	Immune System
RNF111	Disease
RNF125	Immune System
RNF123	Immune System
RNF135	Immune System
RNF138	Immune System
RRM2B	Metabolism
SDCCAG8	Cell Cycle
SDR9C7	Disease
SCN9A	Developmental Biology
SLC5A7	Amine compound SLC transporters
SCARA5	Binding and Uptake of Ligands by Scavenger Receptors
TECRL	Metabolism
SRD5A3	Metabolism
SLC6A19	Amine compound SLC transporters
SLC4A7	Transmembrane transport of small molecules
SLC9C1	Transmembrane transport of small molecules
SLC9C2	Transmembrane transport of small molecules
SACM1L	Metabolism
SLC4A10	Transmembrane transport of small molecules
SLC47A2	Bile salt and organic anion SLC transporters
SLC4A4	Transmembrane transport of small molecules
SLC41A2	Transmembrane transport of small molecules
SLC39A14	Transmembrane transport of small molecules
SLC41A1	Transmembrane transport of small molecules
SLC47A1	Bile salt and organic anion SLC transporters
SLC39A10	Transmembrane transport of small molecules
SLC39A8	Transmembrane transport of small molecules
SLC39A6	Transmembrane transport of small molecules
SLC39A5	Transmembrane transport of small molecules
SLC39A4	Transmembrane transport of small molecules
SLC39A3	Transmembrane transport of small molecules
SLC38A4	Amino acid and oligopeptide SLC transporters
SLC38A5	Amino acid and oligopeptide SLC transporters
SLC36A2	Amino acid and oligopeptide SLC transporters
SLC35B3	Disease
SLC35B4	Transmembrane transport of small molecules
SLC35D2	Disease
SLC29A4	Transmembrane transport of small molecules
SLC27A6	Transmembrane transport of small molecules
SLC35B2	Disease
SLC27A1	Metabolism
SLC27A4	Transmembrane transport of small molecules
SLC26A9	Transmembrane transport of small molecules
SLC26A7	Transmembrane transport of small molecules
SLC22A18	Transmembrane transport of small molecules
SLC22A16	Transmembrane transport of small molecules
SLC22A12	Transmembrane transport of small molecules
SLC22A11	Transmembrane transport of small molecules
SLC22A8	Transmembrane transport of small molecules
SLC22A7	Transmembrane transport of small molecules
SLC20A1	Transmembrane transport of small molecules
SLC22A2	Amine compound SLC transporters
SLC22A6	Transmembrane transport of small molecules
SLC13A5	Bile salt and organic anion SLC transporters
SLC15A3	Amino acid and oligopeptide SLC transporters
CHAT	Metabolism
IGLC7	Binding and Uptake of Ligands by Scavenger Receptors
IGLC6	Binding and Uptake of Ligands by Scavenger Receptors
SLC7A6	Amino acid and oligopeptide SLC transporters
ZNF717	Gene Expression
ZNF714	Gene Expression
ZNF737	Gene Expression
ZNF720	Gene Expression
ZNF726P1	Gene Expression
ZNF705F	Gene Expression
ZNF729	Gene Expression
ZNF724P	Gene Expression
ZNF840	Gene Expression
ZNF726	Gene Expression
ZNF730	Gene Expression
SLCO4C1	Transmembrane transport of small molecules
VARS2	Gene Expression
SFI1	Cell Cycle
SIGLEC16	Immune System
SLC4A5	Transmembrane transport of small molecules
SLC22A15	Transmembrane transport of small molecules
SLC22A1	Amine compound SLC transporters
SLC20A2	Transmembrane transport of small molecules
SLC15A4	Amino acid and oligopeptide SLC transporters
SLC5A9	Disease
SLC5A11	Transmembrane transport of small molecules
SLC5A8	Amino acid and oligopeptide SLC transporters
SLC4A8	Transmembrane transport of small molecules
RQCD1	Gene Expression
XAF1	Immune System
USP41	Immune System
SLC17A8	Amino acid and oligopeptide SLC transporters
VPS37D	Disease
WIPF3	Immune System
TRPM1	Transmembrane transport of small molecules
TRPM5	Transmembrane transport of small molecules
TRPM3	Transmembrane transport of small molecules
ARHGAP33	Signal Transduction
TBC1D8B	Membrane Trafficking
H3F3A	Cell Cycle
HIST1H4A	Cell Cycle
HIST1H3A	Cell Cycle
HIST2H3A	Cell Cycle
GLRA4	Transmembrane transport of small molecules
GMPPA	Metabolism of proteins
HMHA1	Signal Transduction
KIF15	Hemostasis
MLST8	Cellular responses to stress
MUC4	Metabolism of proteins
MUC21	Metabolism of proteins
MUC12	Metabolism of proteins
MICB	Immune System
OR8U9	Signal Transduction
OR8U8	Signal Transduction
OR9G9	Signal Transduction
OR51J1	Signal Transduction
OR11H2	Signal Transduction
SLC9B2	Transmembrane transport of small molecules
PLCH1	Metabolism
PGS1	Metabolism
PDPR	Metabolism
ASIC5	Transmembrane transport of small molecules
ACSM4	Metabolism
BDP1	Gene Expression
CACNA1C	Developmental Biology
COL6A6	Developmental Biology
COL6A5	Developmental Biology
ZNF839	Gene Expression
EEF1A1P5	Gene Expression
ERCC6L	Cell Cycle
FCGR1B	Immune System
G6PC2	Disease
GABRR3	Neuronal System
G6PC3	Disease
KCNS3	Metabolism
KCNB1	Metabolism
IQGAP1	Cell-Cell communication
KCNG2	Metabolism
AKAP5	Metabolism
GLP1R	Metabolism
PAPPA	Metabolism of proteins
IGFBP6	Metabolism of proteins
IGFBP3	Metabolism of proteins
IGFBP5	Metabolism of proteins
KLK3	Metabolism of proteins
CTSL1	Extracellular matrix organization
IGFBP2	Metabolism of proteins
MMP2	Extracellular matrix organization
IGFALS	Metabolism of proteins
IGFBP4	Metabolism of proteins
IGFBP1	Metabolism of proteins
PIK3AP1	Immune System
IZUMO3	Reproduction
CYP4A22	Metabolism
EED	Cellular responses to stress
B3GNT9	Metabolism of proteins
ASAH2C	Metabolism
SYN3	Neuronal System
GNAT3	Hemostasis
hly	Immune System
ZNF860	Gene Expression
ZNF99	Gene Expression
ZNF688	Gene Expression
ZNF727	Gene Expression
ZNF785	Gene Expression
ZNF75CP	Gene Expression
ZNF705E	Gene Expression
ZNF705G	Gene Expression
KCNU1	Reproduction
LIN54	Cell Cycle
HVCN1	Reproduction
ARHGAP32	Signal Transduction
PLCZ1	Metabolism
NEURL1B	Disease
POM121	Cell Cycle
PLA2G4B	Metabolism
OR2W5	Signal Transduction
OR2T7	Signal Transduction
OR9A1P	Signal Transduction
Putative olfactory receptor GPCRLTM7	Signal Transduction
OR2W6P	Signal Transduction
OR10AC1P	Signal Transduction
OR14A2	Signal Transduction
OR56A5	Signal Transduction
OR10D3	Signal Transduction
MYL12B	Developmental Biology
MYO9A	Signal Transduction
MYH7B	Membrane Trafficking
MUC19	Metabolism of proteins
NCOA6	Metabolism
ASB14	Immune System
RAET1E	Immune System
SLC30A5	Metabolism of proteins
WIPF2	Immune System
PANK1	Disease
ABCA10	Transmembrane transport of small molecules
BLNK	Immune System
BRK1	Immune System
HDAC7	Disease
RAPGEF4	Hemostasis
DGCR8	Gene Expression
DIO2	Metabolism
KAT2A	Chromatin organization
SHC3	Signal Transduction
NCSTN	A third proteolytic cleavage releases NICD
PVRL2	Cell-Cell communication
ADC	Metabolism
APH1A	A third proteolytic cleavage releases NICD
HDAC10	Disease
MED8	Developmental Biology
LINGO1	Signal Transduction
CYFIP2	Immune System
FGD4	Signal Transduction
DEPDC7	Signal Transduction
ARAP1	Signal Transduction
KCNC2	Metabolism
CYP2S1	Metabolism
MED15	Developmental Biology
TSG101	Disease
PDCD1LG2	Immune System
MAPKAP1	Disease
ARHGAP9	Signal Transduction
PAPPA2	Metabolism of proteins
UGT2B28	Metabolism
HELZ2	Developmental Biology
AMICA1	Hemostasis
TIAM2	Metabolism
ARHGAP12	Signal Transduction
RHOT2	Signal Transduction
RHOT1	Signal Transduction
KIRREL3	Cell-Cell communication
ABI1	Immune System
IZUMO1	Reproduction
NGEF	Signal Transduction
ENAH	Developmental Biology
TAGAP	Signal Transduction
ARHGAP24	Signal Transduction
NCOR2	Developmental Biology
MYO5A	Immune System
NCOA3	Developmental Biology
STARD13	Signal Transduction
MED16	Developmental Biology
AKT3	Apoptosis
PISD	Metabolism
LRRC41	Immune System
SEMA6A	Developmental Biology
ARHGEF3	Signal Transduction
ARHGEF4	Signal Transduction
PVRL3	Cell-Cell communication
A1CF	Gene Expression
SMURF1	Disease
CYP3A43	Metabolism
XPO5	Gene Expression
SEC61A2	Gene Expression
RHOJ	Signal Transduction
ARHGAP23	Signal Transduction
ARHGAP28	Signal Transduction
ARHGAP20	Signal Transduction
SMOX	Metabolism
ARHGEF12	Developmental Biology
CD274	Immune System
DROSHA	Gene Expression
EXOC1	Membrane Trafficking
HDAC5	Disease
BAIAP2	Immune System
MYO6	Membrane Trafficking
MED23	Developmental Biology
EXOC7	Membrane Trafficking
CD84	Hemostasis
MCM8	Cell Cycle
SRP68	Gene Expression
HDAC9	Disease
VAV3	Hemostasis
REV1	DNA Repair
TJP1	Apoptosis
RBPJ	Disease
GSTM4	Metabolism
OCRL	Membrane Trafficking
CACNA1D	Developmental Biology
ABCC8	Metabolism
DDR1	Extracellular matrix organization
EIF5A	Metabolism of proteins
SEC61A1	Gene Expression
SNAP25	Disease
CXCR4	Disease
CDC42	Developmental Biology
HSD17B7	Metabolism
DAB2	Membrane Trafficking
ARHGAP8	Signal Transduction
SIRPA	Cell-Cell communication
CXCL12	Signal Transduction
ARRB1	Disease
CX3CR1	Signal Transduction
GSK3B	Cellular responses to stress
PSEN2	A third proteolytic cleavage releases NICD
TSC2	Disease
PSEN1	Extracellular matrix organization
VEGFB	Hemostasis
PGF	Signal Transduction
CXCR3	Signal Transduction
CCR2	Immune System
ARHGAP25	Signal Transduction
STAT6	Immune System
GRIA2	Neuronal System
GRIA3	Neuronal System
GRIA1	Neuronal System
SSR1	Gene Expression
CASP2	Immune System
ASMT	Metabolism
KIR2DL3	Immune System
ABCG1	Metabolism
CLTCL1	Membrane Trafficking
UCP3	Metabolism
DIO1	Metabolism
DNM2	Developmental Biology
RAB27A	Metabolism of proteins
CCR9	Signal Transduction
CHN2	Signal Transduction
CXCR5	Signal Transduction
KLRC1	Immune System
ITGB7	Extracellular matrix organization
NOS1	Disease
PCSK6	Developmental Biology
EPHB2	Developmental Biology
ABCD3	Transmembrane transport of small molecules
PPARG	Developmental Biology
HNF1B	Developmental Biology
PEX19	Transmembrane transport of small molecules
STAT3	Developmental Biology
GCK	Developmental Biology
PFN2	Developmental Biology
TCF3	Developmental Biology
CHN1	Signal Transduction
PPP3CB	Calcineurin dephosphorylates NFATC1,2,3
PVR	Cell-Cell communication
VEGFA	Cellular responses to stress
ATF3	Metabolism of proteins
ELK1	Immune System
HMGA1	Cellular responses to stress
TPH1	Metabolism
FLT1	Signal Transduction
APC	Apoptosis
NFYA	Metabolism
ATP2B4	Hemostasis
VAMP1	Disease
TH	Metabolism
TPO	Metabolism
NPM1	Cell Cycle
CLTB	Membrane Trafficking
HMBS	Metabolism
MET	Developmental Biology
CD8B	Disease
MCF2	Signal Transduction
THRB	Gene Expression
THRA	Gene Expression
IL8	Cellular responses to stress
FAM13A	Signal Transduction
MBD4	DNA Repair
RAPGEF3	Hemostasis
MED26	Developmental Biology
PAPSS2	Disease
PAK4	Developmental Biology
IGF2	Hemostasis
SRGAP3	Developmental Biology
BCL2L11	Apoptosis
ARHGAP6	Signal Transduction
SMAD6	Signal Transduction
SLC37A4	Disease
EXOC3	Membrane Trafficking
NRP2	Developmental Biology
KALRN	Signal Transduction
NCOR1	Circadian Clock
ABCB7	Metabolism
LILRA1	Immune System
TRIO	Developmental Biology
PAK3	Developmental Biology
RAD17	Cell Cycle
PSIP1	Disease
NET1	Signal Transduction
SRGAP1	Developmental Biology
FGD2	Signal Transduction
CYP2U1	Metabolism
SYDE1	Signal Transduction
ARHGAP36	Signal Transduction
KIRREL2	Cell-Cell communication
IYD	Metabolism
SLC30A6	Metabolism of proteins
MED27	Developmental Biology
ARHGAP17	Signal Transduction
ARHGEF16	Signal Transduction
OBSCN	Signal Transduction
FGD3	Signal Transduction
PDIA6	Metabolism of proteins
HERPUD1	Metabolism of proteins
PVRL1	Cell-Cell communication
PPP2R5B	Cell Cycle
MED1	Developmental Biology
MYLK	Muscle contraction
MAPK14	Cell-Cell communication
ETFDH	Metabolism
ITSN1	Signal Transduction
NCOA1	Developmental Biology
UGP2	Disease
DUSP6	Immune System
NTRK2	Signal Transduction
STX1A	Disease
AKAP13	Signal Transduction
ABR	Signal Transduction
ACACA	Disease
CBLB	Immune System
DNAJC3	Metabolism of proteins
KLRD1	Immune System
SKP2	Cell Cycle
ITGB3BP	Cell Cycle
PPP2R5C	Cell Cycle
MYO9B	Immune System
PICALM	Membrane Trafficking
ATR	Cell Cycle
TUBA3C	Cell Cycle
NFYC	Metabolism
RASGRF1	Neuronal System
RAPGEF1	Immune System
ARHGEF7	Disease
ITPR2	Disease
PPP2R5D	Cell Cycle
ITPR1	Disease
ICAM4	Extracellular matrix organization
GBP3	Immune System
RAD51B	Hemostasis
HDAC3	Circadian Clock
PER2	Circadian Clock
PER1	Circadian Clock
NRP1	Developmental Biology
SULT1C2	Metabolism
SUPT5H	Disease
fljB	Immune System
bfrB	Disease
ZNF735	Gene Expression
IGLC3	Binding and Uptake of Ligands by Scavenger Receptors
ZNF736	Gene Expression
UBC	APC-Cdc20 mediated degradation of Nek2A
IGLC2	Binding and Uptake of Ligands by Scavenger Receptors
IGLC1	Binding and Uptake of Ligands by Scavenger Receptors
GSTT2	Metabolism
UBB	APC-Cdc20 mediated degradation of Nek2A
GSTT2B	Metabolism
CFC1	Developmental Biology
ZNF732	Gene Expression
KCNAB1	Neuronal System
ZNF705D	Gene Expression
Beta-defensin 117	Immune System
SAA1	Binding and Uptake of Ligands by Scavenger Receptors
Rv1281c	Disease
fgd1	Disease
Rv1283c	Disease
Rv1280c	Disease
Rv2238c	Disease
Rv1282c	Disease
